"","geoid","county","state","births","deaths","domesticmig","internationalmig","naturalinc","netmig","rbirth","rdeath","rdomesticmig","rinternationalmig","rnaturalinc","rnetmig"
"1","01001","Autauga County","Alabama",650,583,-107,5,67,-102,11.84898919,10.627631843,-1.950525913,0.0911460707,1.2213573473,-1.859379842
"2","01003","Baldwin County","Alabama",2256,2090,3430,176,166,3606,11.218745649,10.393252839,17.056869493,0.8752212917,0.8254928093,17.932090784
"3","01005","Barbour County","Alabama",272,330,-427,15,-58,-412,10.254090326,12.440624293,-16.09741386,0.5654829224,-2.186533967,-15.53193094
"4","01007","Bibb County","Alabama",252,262,23,11,-10,34,11.174422987,11.617852471,1.0198878123,0.487772432,-0.443429484,1.5076602443
"5","01009","Blount County","Alabama",716,635,-90,16,81,-74,12.447519623,11.039350504,-1.564632355,0.2781568631,1.4081691194,-1.286475492
"6","01011","Bullock County","Alabama",124,133,-257,-2,-9,-259,11.773083314,12.627581296,-24.40066461,-0.189888441,-0.854497982,-24.59055305
"7","01013","Butler County","Alabama",239,277,-153,26,-38,-127,11.796934771,13.67259804,-7.552012636,1.2833485525,-1.875663269,-6.268664084
"8","01015","Calhoun County","Alabama",1387,1454,-438,55,-67,-383,11.981116999,12.559873192,-3.783510631,0.475098367,-0.578756192,-3.308412264
"9","01017","Chambers County","Alabama",421,446,31,23,-25,54,12.384720608,13.120155324,0.9119390472,0.6765999382,-0.735434715,1.5885389854
"10","01019","Cherokee County","Alabama",231,338,-52,0,-107,-52,8.9463798145,13.090373928,-2.013903681,0,-4.143994113,-2.013903681
"11","01021","Chilton County","Alabama",533,504,-119,41,29,-78,12.184806712,11.521843495,-2.72043527,0.937292824,0.662963217,-1.783142446
"12","01023","Choctaw County","Alabama",159,184,-58,-1,-25,-59,11.97740113,13.860640301,-4.369114878,-0.075329567,-1.883239171,-4.444444444
"13","01025","Clarke County","Alabama",312,295,-177,-2,17,-179,12.588766946,11.902840542,-7.141704325,-0.080697224,0.6859264041,-7.222401549
"14","01027","Clay County","Alabama",153,201,24,-1,-48,23,11.395374818,14.970394369,1.7875097754,-0.074479574,-3.575019551,1.7130302015
"15","01029","Cleburne County","Alabama",149,209,-37,-8,-60,-45,9.9525749783,13.960323292,-2.471444793,-0.534366442,-4.007748313,-3.005811235
"16","01031","Coffee County","Alabama",619,533,133,84,86,217,12.184199907,10.491403151,2.617929867,1.6534293897,1.6927967561,4.2713592567
"17","01033","Colbert County","Alabama",604,744,43,7,-140,50,11.099064665,13.671695548,0.7901651997,0.1286315441,-2.572630883,0.9187967438
"18","01035","Conecuh County","Alabama",154,171,19,1,-17,20,12.145589337,13.486336212,1.4984818013,0.0788674632,-1.340746875,1.5773492646
"19","01037","Coosa County","Alabama",97,137,-73,15,-40,-58,8.8278121587,12.46814707,-6.643611212,1.3651255916,-3.640334911,-5.278485621
"20","01039","Covington County","Alabama",465,593,-69,-2,-128,-71,12.349449586,15.748867967,-1.832498971,-0.053115912,-3.399418381,-1.885614883
"21","01041","Crenshaw County","Alabama",158,215,56,0,-57,56,11.401356617,15.514504257,4.0409871554,0,-4.11314764,4.0409871554
"22","01043","Cullman County","Alabama",1013,967,610,42,46,652,12.442348202,11.877345223,7.4924308025,0.5158722848,0.5650029785,8.0083030872
"23","01045","Dale County","Alabama",640,533,-272,100,107,-172,12.95992548,10.793187939,-5.507968329,2.0249883563,2.1667375413,-3.482979973
"24","01047","Dallas County","Alabama",490,516,-602,7,-26,-595,11.8773482,12.507574839,-14.59217065,0.1696764029,-0.630226639,-14.42249424
"25","01049","DeKalb County","Alabama",838,808,52,42,30,94,11.793597962,11.371392785,0.7318223079,0.5910872487,0.4222051776,1.3229095566
"26","01051","Elmore County","Alabama",935,773,146,57,162,203,11.579520967,9.5732296337,1.8081391029,0.705917321,2.0062913333,2.5140564238
"27","01053","Escambia County","Alabama",400,473,2,3,-73,5,10.609657441,12.545919924,0.0530482872,0.0795724308,-1.936262483,0.132620718
"28","01055","Etowah County","Alabama",1154,1374,-205,31,-220,-174,11.181628797,13.313308464,-1.986337871,0.3003730439,-2.131679667,-1.685964827
"29","01057","Fayette County","Alabama",192,230,-39,5,-38,-34,11.476046741,13.747347658,-2.331071994,0.2988553839,-2.271300917,-2.03221661
"30","01059","Franklin County","Alabama",404,376,-103,55,28,-48,12.804665462,11.917213401,-3.264555799,1.743209407,0.8874520617,-1.521346392
"31","01061","Geneva County","Alabama",301,356,103,-6,-55,97,11.308774632,13.375162024,3.8697800237,-0.225424079,-2.066387391,3.6443559446
"32","01063","Greene County","Alabama",97,113,-62,1,-16,-61,11.349011349,13.221013221,-7.254007254,0.117000117,-1.872001872,-7.137007137
"33","01065","Hale County","Alabama",212,179,-62,0,33,-62,14.102777316,11.907533677,-4.12439714,0,2.1952436388,-4.12439714
"34","01067","Henry County","Alabama",162,211,71,4,-49,75,9.477009477,12.343512344,4.1535041535,0.234000234,-2.866502867,4.3875043875
"35","01069","Houston County","Alabama",1268,1093,-90,40,175,-50,12.167504702,10.48823552,-0.863624151,0.3838329559,1.6792691821,-0.479791195
"36","01071","Jackson County","Alabama",524,714,-164,16,-190,-148,10.001908761,13.628555068,-3.130368391,0.3054017942,-3.626646307,-2.824966597
"37","01073","Jefferson County","Alabama",8993,7216,-1899,649,1777,-1250,13.622785332,10.930948399,-2.876645096,0.9831188347,2.6918369325,-1.893526261
"38","01075","Lamar County","Alabama",162,186,-117,0,-24,-117,11.574735639,13.289511289,-8.359531295,0,-1.71477565,-8.359531295
"39","01077","Lauderdale County","Alabama",953,1094,-429,42,-141,-387,10.275486549,11.795784139,-4.625586285,0.4528546013,-1.52029759,-4.172731684
"40","01079","Lawrence County","Alabama",370,412,-267,-2,-42,-269,11.113447271,12.374973718,-8.019703842,-0.060072688,-1.261526447,-8.07977653
"41","01081","Lee County","Alabama",1912,1088,1116,522,824,1638,12.273955719,6.9843430031,7.1640871245,3.3509439776,5.2896127156,10.515031102
"42","01083","Limestone County","Alabama",1031,755,657,43,276,700,11.319283954,8.2890973667,7.2131615496,0.4720942871,3.030186587,7.6852558367
"43","01085","Lowndes County","Alabama",129,146,-127,-1,-17,-128,12.373507266,14.004124502,-12.18166994,-0.095918661,-1.630617237,-12.2775886
"44","01087","Macon County","Alabama",187,238,-292,0,-51,-292,9.6010679263,12.219540997,-14.9920419,0,-2.618473071,-14.9920419
"45","01089","Madison County","Alabama",4207,3039,1505,542,1168,2047,11.972179694,8.6483133086,4.2828929021,1.5424105999,3.3238663851,5.825303502
"46","01091","Marengo County","Alabama",255,273,-208,4,-18,-204,12.833417212,13.739305486,-10.46804227,0.2013085053,-0.905888274,-10.26673377
"47","01093","Marion County","Alabama",318,404,7,5,-86,12,10.542892665,13.394115209,0.2320762536,0.1657687526,-2.851222545,0.3978450062
"48","01095","Marshall County","Alabama",1331,1068,19,61,263,80,14.093380558,11.308587856,0.2011827428,0.6459024899,2.7847927024,0.8470852327
"49","01097","Mobile County","Alabama",5691,4142,-1758,589,1549,-1169,13.721105452,9.9864380218,-4.238570266,1.4200898104,3.7346674302,-2.818480456
"50","01099","Monroe County","Alabama",215,279,-144,-2,-64,-146,9.8524424892,12.785262579,-6.598845202,-0.091650628,-2.93282009,-6.69049583
"51","01101","Montgomery County","Alabama",3230,2230,-1725,427,1000,-1298,14.204358055,9.8067239825,-7.585918776,1.8777897491,4.3976340729,-5.708129027
"52","01103","Morgan County","Alabama",1359,1254,-391,116,105,-275,11.38481773,10.505196051,-3.275543585,0.9717725215,0.8796216789,-2.303771064
"53","01105","Perry County","Alabama",125,133,-159,-1,-8,-160,12.858759387,13.681719988,-16.35634194,-0.102870075,-0.822960601,-16.45921202
"54","01107","Pickens County","Alabama",234,261,504,3,-27,507,11.398231813,12.713412407,24.550037751,0.1461311771,-1.315180594,24.696168928
"55","01109","Pike County","Alabama",380,314,127,131,66,258,11.391058019,9.4126111003,3.807011496,3.9269173699,1.9784469192,7.7339288658
"56","01111","Randolph County","Alabama",274,302,272,-2,-28,270,12.190510088,13.436255645,12.101528263,-0.088981825,-1.245745556,12.012546437
"57","01113","Russell County","Alabama",936,615,-754,52,321,-702,15.857956086,10.419490377,-12.77446462,0.8809975603,5.4384657089,-11.89346706
"58","01115","St. Clair County","Alabama",1026,913,402,42,113,444,11.892825473,10.582991869,4.6597620276,0.4868408089,1.3098336048,5.1466028364
"59","01117","Shelby County","Alabama",2404,1372,1502,205,1032,1707,11.573271712,6.6050452532,7.2308877335,0.9869054496,4.9682264587,8.2177931831
"60","01119","Sumter County","Alabama",166,156,-122,43,10,-79,12.537290888,11.782032401,-9.214153544,3.247611495,0.7552584872,-5.966542049
"61","01121","Talladega County","Alabama",868,919,-372,34,-51,-338,10.682748223,11.310421218,-4.578320667,0.4184486631,-0.627672995,-4.159872004
"62","01123","Tallapoosa County","Alabama",475,478,-263,-10,-3,-273,11.656727772,11.730349211,-6.454146114,-0.245404795,-0.073621439,-6.699550909
"63","01125","Tuscaloosa County","Alabama",2485,1768,624,311,717,935,12.186360594,8.6702155049,3.0600760605,1.5251340622,3.5161450888,4.5852101228
"64","01127","Walker County","Alabama",805,1058,-154,8,-253,-146,12.359041675,16.243311916,-2.364338407,0.1228227744,-3.884270241,-2.241515633
"65","01129","Washington County","Alabama",178,222,-10,14,-44,4,10.565052232,13.176638177,-0.59354226,0.8309591643,-2.611585945,0.2374169041
"66","01131","Wilcox County","Alabama",122,150,-22,0,-28,-22,11.16398243,13.726207906,-2.01317716,0,-2.562225476,-2.01317716
"67","01133","Winston County","Alabama",235,285,-162,4,-50,-158,9.778221612,11.858694295,-6.740731494,0.1664378147,-2.080472683,-6.57429368
"68","02013","Aleutians East Borough","Alaska",10,7,-54,84,3,30,2.972209838,2.0805468866,-16.04993313,24.966562639,0.8916629514,8.916629514
"69","02016","Aleutians West Census Area","Alaska",30,17,-157,100,13,-57,5.1710764457,2.9302766526,-27.06196673,17.236921486,2.2407997932,-9.825045247
"70","02020","Anchorage Municipality","Alaska",4642,1680,-6474,1119,2962,-5355,15.537035178,5.6230545235,-21.66884225,3.7453559594,9.913980654,-17.92348629
"71","02050","Bethel Census Area","Alaska",414,119,-279,3,295,-276,23.071778868,6.6317432011,-15.54837272,0.1671868034,16.440035667,-15.38118591
"72","02060","Bristol Bay Borough","Alaska",10,6,-50,1,4,-49,10.787486516,6.4724919094,-53.93743258,1.0787486516,4.3149946063,-52.85868393
"73","02068","Denali Borough","Alaska",16,7,-14,18,9,4,8.3289953149,3.6439354503,-7.287870901,9.3701197293,4.6850598647,2.0822488287
"74","02070","Dillingham Census Area","Alaska",97,36,-56,0,61,-56,19.458375125,7.221664995,-11.2337011,0,12.23671013,-11.2337011
"75","02090","Fairbanks North Star Borough","Alaska",1698,492,-1312,474,1206,-838,17.075108354,4.9475578975,-13.19348773,4.7665496817,12.127550456,-8.426938045
"76","02100","Haines Borough","Alaska",18,17,-42,1,1,-41,7.099191481,6.7047919542,-16.56478012,0.3943995267,0.3943995267,-16.1703806
"77","02105","Hoonah-Angoon Census Area","Alaska",18,23,31,8,-5,39,8.4905660377,10.849056604,14.622641509,3.7735849057,-2.358490566,18.396226415
"78","02110","Juneau City and Borough","Alaska",384,200,-133,76,184,-57,11.80140449,6.1465648386,-4.087465618,2.3356946387,5.6548396515,-1.751770979
"79","02122","Kenai Peninsula Borough","Alaska",702,442,161,48,260,209,12.145959133,7.6474557503,2.78561171,0.8304929322,4.4985033825,3.6161046421
"80","02130","Ketchikan Gateway Borough","Alaska",163,100,-201,40,63,-161,11.851528702,7.2708765042,-14.61446177,2.9083506017,4.5806521976,-11.70611117
"81","02150","Kodiak Island Borough","Alaska",223,60,-412,104,163,-308,16.118539935,4.3368268883,-29.77954463,7.5171666064,11.781713047,-22.26237803
"82","02158","Kusilvak Census Area","Alaska",222,54,-91,10,168,-81,27.2643537,6.6318698189,-11.17592877,1.2281240405,20.632483881,-9.947804728
"83","02164","Lake and Peninsula Borough","Alaska",31,19,-72,5,12,-67,19.153537226,11.739264751,-44.48563485,3.0892801977,7.4142724745,-41.39635465
"84","02170","Matanuska-Susitna Borough","Alaska",1511,587,1926,91,924,2017,15.172815456,5.8944028277,19.340067881,0.9137830619,9.2784126283,20.253850943
"85","02180","Nome Census Area","Alaska",245,59,-110,6,186,-104,24.888256806,5.9934985778,-11.17431938,0.6095083299,18.894758228,-10.56481105
"86","02185","North Slope Borough","Alaska",172,44,-124,21,128,-103,17.583316295,4.4980576569,-12.67634431,2.1468002453,13.085258638,-10.52954406
"87","02188","Northwest Arctic Borough","Alaska",159,48,-121,8,111,-113,20.46068717,6.1768112212,-15.57071162,1.0294685369,14.283875949,-14.54124308
"88","02195","Petersburg Borough","Alaska",37,16,-36,8,21,-28,11.342734519,4.9049662784,-11.03617413,2.4524831392,6.4377682403,-8.583690987
"89","02198","Prince of Wales-Hyder Census Area","Alaska",77,33,-3,4,44,1,11.878133436,5.0906286155,-0.46278442,0.6170458928,6.7875048207,0.1542614732
"90","02220","Sitka City and Borough","Alaska",70,69,-101,39,1,-62,7.9468695011,7.8333427939,-11.46619742,4.4275415792,0.1135267072,-7.038655844
"91","02230","Skagway Municipality","Alaska",15,4,22,0,11,22,14.018691589,3.738317757,20.560747664,0,10.280373832,20.560747664
"92","02240","Southeast Fairbanks Census Area","Alaska",123,57,-211,26,66,-185,17.922191461,8.3054057992,-30.74457234,3.7884307154,9.6167856622,-26.95614163
"93","02261","Valdez-Cordova Census Area","Alaska",129,69,-217,1,60,-216,13.72559451,7.3415970634,-23.08879076,0.1063999574,6.3839974464,-22.98239081
"94","02275","Wrangell City and Borough","Alaska",23,32,14,7,-9,21,9.3762739503,13.045250713,5.7072971871,2.8536485936,-3.668976763,8.5609457807
"95","02282","Yakutat City and Borough","Alaska",9,4,-26,1,5,-25,13.953488372,6.2015503876,-40.31007752,1.5503875969,7.7519379845,-38.75968992
"96","02290","Yukon-Koyukuk Census Area","Alaska",87,53,-36,3,34,-33,15.919487649,9.6980786825,-6.587374199,0.54894785,6.2214089661,-6.038426349
"97","04001","Apache County","Arizona",958,612,-1217,59,346,-1158,13.413421823,8.5689083043,-17.03980622,0.8260875653,4.8445135184,-16.21371865
"98","04003","Cochise County","Arizona",1604,1251,-1699,481,353,-1218,12.637185154,9.8560589945,-13.38564687,3.7895798372,2.7811261591,-9.596067031
"99","04005","Coconino County","Arizona",1677,787,369,180,890,549,12.125506585,5.6903838298,2.6680452772,1.3014855011,6.4351227554,3.9695307783
"100","04007","Gila County","Arizona",606,784,90,32,-178,122,11.425770202,14.781854519,1.6968965647,0.6033410008,-3.356084317,2.3002375655
"101","04009","Graham County","Arizona",577,279,-627,71,298,-556,15.184809927,7.3423950945,-16.50065134,1.868494809,7.8424148322,-14.63215653
"102","04011","Greenlee County","Arizona",163,54,103,23,109,126,17.234087545,5.7094523155,10.890251639,2.431803764,11.524635229,13.322055403
"103","04012","La Paz County","Arizona",215,266,-109,113,-51,4,10.484736175,12.971813128,-5.31551741,5.5105822686,-2.487076953,0.1950648591
"104","04013","Maricopa County","Arizona",55660,28488,39243,12903,27172,52146,13.459794788,6.8890160602,9.4898082439,3.1202251553,6.5707787275,12.610033399
"105","04015","Mohave County","Arizona",1856,2858,2300,-123,-1002,2177,9.0950298308,14.005169858,11.270780502,-0.60274174,-4.910140027,10.668038762
"106","04017","Navajo County","Arizona",1572,958,-746,99,614,-647,14.595287171,8.894583403,-6.926262232,0.9191688485,5.7007037677,-6.007093384
"107","04019","Pima County","Arizona",11741,9173,-753,3364,2568,2611,11.65699966,9.1073722754,-0.747612703,3.3399324468,2.5496273851,2.5923197439
"108","04021","Pinal County","Arizona",4510,2776,7180,1161,1734,8341,11.247051078,6.9227968498,17.905504821,2.8953051667,4.3242542282,20.800809987
"109","04023","Santa Cruz County","Arizona",624,282,-724,272,342,-452,13.375488988,6.0446921387,-15.51899684,5.8303413536,7.330796849,-9.688655485
"110","04025","Yavapai County","Arizona",1975,2851,3903,32,-876,3935,9.0062564982,13.000930266,17.798186892,0.1459241559,-3.994673768,17.944111048
"111","04027","Yuma County","Arizona",3027,1431,-1998,1568,1596,-430,14.775259372,6.9849343118,-9.752549794,7.6536526911,7.7903250606,-2.098897103
"112","05001","Arkansas County","Arkansas",246,245,-151,-2,1,-153,13.369201924,13.314855575,-8.206298742,-0.108692699,0.0543463493,-8.31499144
"113","05003","Ashley County","Arkansas",253,270,-97,-5,-17,-102,12.106132019,12.91958753,-4.641481446,-0.239251621,-0.813455511,-4.880733067
"114","05005","Baxter County","Arkansas",386,640,483,20,-254,503,9.412338454,15.605949768,11.777615216,0.4876859303,-6.193611314,12.265301146
"115","05007","Benton County","Arkansas",3555,1853,4312,721,1702,5033,14.318655537,7.4634229844,17.367663199,2.9040086194,6.8552325523,20.271671819
"116","05009","Boone County","Arkansas",440,450,24,1,-10,25,11.857600992,12.127091923,0.6467782359,0.0269490932,-0.269490932,0.6737273291
"117","05011","Bradley County","Arkansas",136,142,-2,1,-6,-1,12.350724243,12.895609136,-0.181628298,0.0908141488,-0.544884893,-0.090814149
"118","05013","Calhoun County","Arkansas",43,57,46,0,-14,46,8.2939531295,10.994309962,8.8726010223,0,-2.700356833,8.8726010223
"119","05015","Carroll County","Arkansas",342,337,-21,60,5,39,12.322104125,12.141956404,-0.756620429,2.1617726536,0.1801477211,1.4051522248
"120","05017","Chicot County","Arkansas",103,159,-193,8,-56,-185,9.2951899648,14.34888548,-17.41720061,0.7219565021,-5.053695515,-16.69524411
"121","05019","Clark County","Arkansas",250,271,-34,10,-21,-24,11.090901025,12.022536711,-1.508362539,0.443636041,-0.931635686,-1.064726498
"122","05021","Clay County","Arkansas",178,214,-60,-1,-36,-61,11.673279339,14.034167295,-3.93481326,-0.065580221,-2.360887956,-4.000393481
"123","05023","Cleburne County","Arkansas",260,367,-132,-3,-107,-135,10.202880352,14.401758035,-5.179923871,-0.117725543,-4.198877683,-5.297649413
"124","05025","Cleveland County","Arkansas",87,105,-97,1,-18,-96,10.430404028,12.588418655,-11.62930104,0.1198897015,-2.158014627,-11.50941134
"125","05027","Columbia County","Arkansas",314,279,7,41,35,48,13.036618783,11.583492485,0.2906252595,1.7022336627,1.4531262974,1.9928589222
"126","05029","Conway County","Arkansas",251,264,-49,4,-13,-45,11.974905179,12.595119391,-2.337730493,0.1908351423,-0.620214212,-2.146895351
"127","05031","Craighead County","Arkansas",1559,909,973,132,650,1105,15.056982809,8.779215762,9.3973343635,1.2748696156,6.2777670466,10.672203979
"128","05033","Crawford County","Arkansas",804,667,-120,83,137,-37,12.996354878,10.78180187,-1.939754459,1.3416635011,2.2145530078,-0.598090958
"129","05035","Crittenden County","Arkansas",829,447,-896,-3,382,-899,16.807233801,9.0625253426,-18.1655989,-0.060822318,7.7447084584,-18.22642121
"130","05037","Cross County","Arkansas",204,234,98,4,-30,102,11.847721927,13.590033975,5.6915526904,0.2323082731,-1.742312048,5.9238609635
"131","05039","Dallas County","Arkansas",81,115,-128,0,-34,-128,10.641792025,15.108717073,-16.816659,0,-4.466925048,-16.816659
"132","05041","Desha County","Arkansas",163,172,-252,10,-9,-242,13.420055986,14.161040672,-20.74757122,0.8233163181,-0.740984686,-19.9242549
"133","05043","Drew County","Arkansas",240,196,-66,0,44,-66,12.883484983,10.521512736,-3.54295837,0,2.3619722468,-3.54295837
"134","05045","Faulkner County","Arkansas",1557,918,-82,101,639,19,12.879690292,7.5938058368,-0.678313811,0.8354840844,5.285884455,0.1571702733
"135","05047","Franklin County","Arkansas",216,250,-47,17,-34,-30,12.1433591,14.054813774,-2.642304989,0.9557273366,-1.911454673,-1.686577653
"136","05049","Fulton County","Arkansas",112,154,90,7,-42,97,9.2485549133,12.716763006,7.4318744839,0.5780346821,-3.468208092,8.009909166
"137","05051","Garland County","Arkansas",1098,1389,318,44,-291,362,11.228716061,14.204632612,3.2520325203,0.4499667638,-2.975916552,3.7019992841
"138","05053","Grant County","Arkansas",196,196,-53,-5,0,-58,10.862637515,10.862637515,-2.937345859,-0.2771081,0,-3.214453958
"139","05055","Greene County","Arkansas",608,450,360,-5,158,355,13.80484759,10.217403644,8.1739229154,-0.113526707,3.5874439462,8.0603962082
"140","05057","Hempstead County","Arkansas",331,247,-325,-2,84,-327,14.899171768,11.118113072,-14.62909615,-0.090025207,3.7810586964,-14.71912135
"141","05059","Hot Spring County","Arkansas",371,424,131,2,-53,133,11.094497608,12.679425837,3.9174641148,0.0598086124,-1.58492823,3.9772727273
"142","05061","Howard County","Arkansas",173,177,-163,9,-4,-154,12.88016975,13.177977143,-12.13565127,0.6700666344,-0.297807393,-11.46558463
"143","05063","Independence County","Arkansas",453,475,-29,11,-22,-18,12.224575985,12.818264002,-0.78258875,0.2968440085,-0.593688017,-0.485744741
"144","05065","Izard County","Arkansas",99,202,26,7,-103,33,7.3235685752,14.943038911,1.923361444,0.5178280811,-7.619470336,2.4411895251
"145","05067","Jackson County","Arkansas",171,241,-151,-1,-70,-152,9.7809300463,13.784819539,-8.63696162,-0.057198421,-4.003889493,-8.694160041
"146","05069","Jefferson County","Arkansas",950,884,-686,21,66,-665,13.163637875,12.249111454,-9.505532192,0.2909856793,0.9145264208,-9.214546513
"147","05071","Johnson County","Arkansas",338,274,36,35,64,71,12.98152629,10.523485809,1.3826477705,1.344240888,2.4580404809,2.7268886584
"148","05073","Lafayette County","Arkansas",74,105,-121,1,-31,-120,10.437971648,14.810635447,-17.06749418,0.1410536709,-4.372663799,-16.92644051
"149","05075","Lawrence County","Arkansas",196,222,-248,3,-26,-245,11.641374395,13.185638345,-14.7299023,0.178184302,-1.54426395,-14.55171799
"150","05077","Lee County","Arkansas",106,122,-150,-1,-16,-151,10.861212152,12.500640402,-15.36963984,-0.102464266,-1.639428249,-15.4721041
"151","05079","Lincoln County","Arkansas",92,125,-135,4,-33,-131,6.5959277316,8.9618583309,-9.678806997,0.2867794666,-2.365930599,-9.392027531
"152","05081","Little River County","Arkansas",114,165,-48,-4,-51,-52,9.1401082381,13.229104029,-3.848466627,-0.320705552,-4.088995791,-4.169172179
"153","05083","Logan County","Arkansas",290,304,-163,31,-14,-132,13.311300835,13.953915358,-7.48186909,1.4229321583,-0.642614523,-6.058936932
"154","05085","Lonoke County","Arkansas",980,676,-422,116,304,-306,13.737611618,9.4761484223,-5.915583778,1.6260846405,4.2614631958,-4.289499138
"155","05087","Madison County","Arkansas",183,192,-27,12,-9,-15,11.641221374,12.213740458,-1.717557252,0.7633587786,-0.572519084,-0.954198473
"156","05089","Marion County","Arkansas",146,262,-102,11,-116,-91,8.9485458613,16.058349422,-6.251723821,0.6742055101,-7.109803561,-5.577518311
"157","05091","Miller County","Arkansas",610,433,187,-16,177,171,13.946363657,9.8996319075,4.2753606621,-0.36580626,4.0467317497,3.9095544022
"158","05093","Mississippi County","Arkansas",675,500,-705,-12,175,-717,15.347013017,11.36815779,-16.02910248,-0.272835787,3.9788552265,-16.30193827
"159","05095","Monroe County","Arkansas",98,126,-156,0,-28,-156,12.990455992,16.702014846,-20.67868505,0,-3.711558855,-20.67868505
"160","05097","Montgomery County","Arkansas",85,147,-83,16,-62,-67,9.3473360092,16.165392863,-9.127398691,1.7594985429,-6.818056854,-7.367900148
"161","05099","Nevada County","Arkansas",111,113,-134,-4,-2,-138,12.934048007,13.167093918,-15.61407597,-0.46609182,-0.23304591,-16.08016779
"162","05101","Newton County","Arkansas",65,101,16,1,-36,17,8.2607866811,12.835991612,2.0334244138,0.1270890259,-4.575204931,2.1605134397
"163","05103","Ouachita County","Arkansas",288,341,-396,4,-53,-392,11.734984924,13.894548122,-16.13560427,0.1629859017,-2.159563198,-15.97261837
"164","05105","Perry County","Arkansas",118,130,-44,2,-12,-42,11.428018014,12.590189337,-4.261294853,0.1936952206,-1.162171323,-4.067599632
"165","05107","Phillips County","Arkansas",308,251,-461,-3,57,-464,15.588227851,12.703393476,-23.33173065,-0.151833388,2.8848343751,-23.48356404
"166","05109","Pike County","Arkansas",113,152,-120,5,-39,-115,10.356520942,13.930895427,-10.99807534,0.458253139,-3.574374484,-10.5398222
"167","05111","Poinsett County","Arkansas",309,366,-90,11,-57,-79,12.830094669,15.196811161,-3.736920777,0.4567347617,-2.366716492,-3.280186016
"168","05113","Polk County","Arkansas",254,305,-14,8,-51,-6,12.558403995,15.079973301,-0.692195496,0.3955402833,-2.521569306,-0.296655212
"169","05115","Pope County","Arkansas",840,578,139,74,262,213,13.260924476,9.1247789846,2.1943672645,1.1682242991,4.1361454913,3.3625915635
"170","05117","Prairie County","Arkansas",84,105,-26,0,-21,-26,10.094940512,12.61867564,-3.124624444,0,-2.523735128,-3.124624444
"171","05119","Pulaski County","Arkansas",5641,3627,-2242,906,2014,-1336,14.342139219,9.2215810931,-5.700243951,2.303488412,5.1205581256,-3.396755539
"172","05121","Randolph County","Arkansas",192,240,-82,-10,-48,-92,10.972996142,13.716245178,-4.686383769,-0.571510216,-2.743249036,-5.257893985
"173","05123","St. Francis County","Arkansas",358,276,-550,18,82,-532,13.320930233,10.269767442,-20.46511628,0.6697674419,3.0511627907,-19.79534884
"174","05125","Saline County","Arkansas",1379,1114,1206,62,265,1268,11.926073909,9.6342613012,10.429909452,0.5361976667,2.2918126076,10.966107118
"175","05127","Scott County","Arkansas",131,112,-143,-3,19,-146,12.355576515,10.563546333,-13.48738505,-0.282952134,1.7920301816,-13.77033718
"176","05129","Searcy County","Arkansas",78,121,-48,6,-43,-42,9.906019812,15.367030734,-6.096012192,0.762001524,-5.461010922,-5.334010668
"177","05131","Sebastian County","Arkansas",1686,1248,131,93,438,224,13.264519378,9.8185766211,1.0306358472,0.7316727771,3.4459427564,1.7623086243
"178","05133","Sevier County","Arkansas",234,163,-217,-12,71,-229,13.486643036,9.394541944,-12.50684418,-0.69162272,4.0921010922,-13.1984669
"179","05135","Sharp County","Arkansas",175,286,93,8,-111,101,10.40644605,17.007106116,5.530282758,0.475723248,-6.600660066,6.006006006
"180","05137","Stone County","Arkansas",135,179,57,-11,-44,46,10.905125409,14.459388505,4.6043862838,-0.888565774,-3.554263096,3.7158205097
"181","05139","Union County","Arkansas",547,521,-72,1,26,-71,13.635287226,12.987174853,-1.794772724,0.024927399,0.6481123727,-1.769845325
"182","05141","Van Buren County","Arkansas",158,226,-47,10,-68,-37,9.3899503759,13.431194841,-2.793213087,0.5943006567,-4.041244466,-2.19891243
"183","05143","Washington County","Arkansas",3155,1526,2190,673,1629,2863,14.196779513,6.8666515174,9.8544998841,3.0283463114,7.330127996,12.882846196
"184","05145","White County","Arkansas",1049,816,192,52,233,244,13.330452905,10.369542012,2.4398922381,0.6608041478,2.9609108931,3.1006963859
"185","05147","Woodruff County","Arkansas",54,108,-97,0,-54,-97,7.9440970945,15.888194189,-14.26995219,0,-7.944097095,-14.26995219
"186","05149","Yell County","Arkansas",271,273,-284,23,-2,-261,12.521080232,12.613486728,-13.12172246,1.062674706,-0.092406496,-12.05904775
"187","06001","Alameda County","California",19501,9719,2842,13358,9782,16200,12.02537656,5.9932636678,1.7525316745,8.2372688625,6.0321128921,9.989800537
"188","06003","Alpine County","California",5,4,1,1,1,2,4.6104195482,3.6883356385,0.9220839096,0.9220839096,0.9220839096,1.8441678193
"189","06005","Amador County","California",306,436,403,25,-130,428,8.2954930532,11.819722128,10.925110132,0.6777363606,-3.524229075,11.602846493
"190","06007","Butte County","California",2474,2308,730,366,166,1096,11.03523335,10.294793279,3.2561521203,1.6325365425,0.7404400712,4.8886886628
"191","06009","Calaveras County","California",357,474,363,36,-117,399,7.9660827848,10.576815798,8.0999665291,0.8033024657,-2.610733013,8.9032689948
"192","06011","Colusa County","California",275,140,-69,7,135,-62,12.951232722,6.5933548402,-3.249582028,0.329667742,6.3578778816,-2.919914286
"193","06013","Contra Costa County","California",12575,7630,5423,4960,4945,10383,11.258014901,6.8309068544,4.8550469032,4.4405370901,4.4271080465,9.2955839933
"194","06015","Del Norte County","California",289,239,3,-1,50,2,10.616413195,8.7796635075,0.1102049813,-0.036734994,1.8367496878,0.0734699875
"195","06017","El Dorado County","California",1601,1484,1228,168,117,1396,8.7053213384,8.0691423274,6.6771609016,0.9134878106,0.636179011,7.5906487123
"196","06019","Fresno County","California",15665,6484,-1947,1996,9181,49,16.218429582,6.7130735658,-2.015785662,2.0665167855,9.505356016,0.0507311235
"197","06021","Glenn County","California",393,266,-198,-10,127,-208,14.128305143,9.5626696385,-7.1180774,-0.359498859,4.5656355041,-7.477576259
"198","06023","Humboldt County","California",1447,1300,431,31,147,462,10.73330663,9.6429154242,3.1969973445,0.2299464447,1.0903912057,3.4269437892
"199","06025","Imperial County","California",3269,980,-1876,519,2289,-1357,18.292614686,5.4838673576,-10.49768894,2.9042113863,12.808747328,-7.593477555
"200","06027","Inyo County","California",196,148,-209,12,48,-197,10.741491752,8.1109223434,-11.45393763,0.6576423522,2.6305694087,-10.79629528
"201","06029","Kern County","California",14092,5826,-2551,1599,8266,-952,16.131377085,6.6691316278,-2.920177615,1.8304053335,9.4622454575,-1.089772281
"202","06031","Kings County","California",2359,818,-1200,251,1541,-949,15.737053122,5.4569349104,-8.005283487,1.6744384627,10.280118211,-6.330845024
"203","06033","Lake County","California",710,859,352,-2,-149,350,11.066774737,13.389238731,5.4866263483,-0.031174013,-2.322463994,5.4554523349
"204","06035","Lassen County","California",291,136,-513,22,155,-491,9.2244781513,4.3110963181,-16.26170891,0.6973832279,4.9133818332,-15.56432568
"205","06037","Los Angeles County","California",128601,60436,-65220,46041,68165,-19179,12.767253342,5.9999667419,-6.474912815,4.5708595665,6.7672866,-1.904053249
"206","06039","Madera County","California",2299,1058,-1166,71,1241,-1095,14.961165396,6.8851296168,-7.587959483,0.4620455603,8.0760357792,-7.125913923
"207","06041","Marin County","California",2303,1923,-498,726,380,228,8.8330447156,7.3755731603,-1.910054828,2.784537761,1.4574715553,0.8744829332
"208","06043","Mariposa County","California",146,190,-63,18,-44,-45,8.2637611433,10.754209707,-3.565869534,1.018819867,-2.490448564,-2.547049667
"209","06045","Mendocino County","California",1022,860,-275,36,162,-239,11.718503655,9.8609717644,-3.153217715,0.4127848646,1.8575318905,-2.740432851
"210","06047","Merced County","California",4106,1680,-708,295,2426,-413,15.45642763,6.3241106719,-2.665160926,1.1104837192,9.1323169584,-1.554677207
"211","06049","Modoc County","California",58,107,6,11,-49,17,6.398940865,11.80494263,0.6619593998,1.213592233,-5.406001765,1.8755516328
"212","06051","Mono County","California",148,36,-278,64,112,-214,10.502040092,2.5545502927,-19.72680504,4.5414227426,7.9474897995,-15.1853823
"213","06053","Monterey County","California",6455,2420,-2851,1083,4035,-1768,15.007771259,5.6264611071,-6.62852918,2.5179575946,9.3813101517,-4.110571586
"214","06055","Napa County","California",1464,1212,45,251,252,296,10.395401597,8.6060291909,0.3195307868,1.7822717219,1.789372406,2.1018025087
"215","06057","Nevada County","California",821,1017,287,42,-196,329,8.3224361119,10.309278351,2.9093047066,0.4257519083,-1.986842239,3.3350566149
"216","06059","Orange County","California",38580,18952,-9594,13888,19628,4294,12.278248405,6.0315542709,-3.053331135,4.4199148224,6.2466941341,1.3665836872
"217","06061","Placer County","California",3648,3044,2655,511,604,3166,9.8277980129,8.2006077717,7.1526325998,1.3766460484,1.6271902412,8.5292786482
"218","06063","Plumas County","California",136,174,-108,4,-38,-104,7.3161547152,9.360374415,-5.809887568,0.215181021,-2.0442197,-5.594706547
"219","06065","Riverside County","California",30538,15764,11830,3540,14774,15370,13.089932094,6.7571448534,5.0708591484,1.517399948,6.3327872408,6.5882590965
"220","06067","Sacramento County","California",19785,11245,4476,5768,8540,10244,13.323627097,7.5726149462,3.0142307247,3.8842901743,5.7510121512,6.8985208989
"221","06069","San Benito County","California",719,298,-35,-3,421,-38,12.38480751,5.1330634743,-0.602876583,-0.051675136,7.2517440358,-0.654551718
"222","06071","San Bernardino County","California",31244,13188,-4508,3160,18056,-1348,14.81429852,6.2530715938,-2.13746184,1.4983095417,8.5612269259,-0.639152298
"223","06073","San Diego County","California",44442,20620,-8394,18099,23822,9705,13.601111789,6.3105828965,-2.568915268,5.5390513988,7.2905288923,2.9701361305
"224","06075","San Francisco County","California",9107,5671,1356,7868,3436,9224,10.620705419,6.6135961823,1.5813853682,9.1757670186,4.0071092369,10.757152387
"225","06077","San Joaquin County","California",9985,5721,4281,1659,4264,5940,13.928994908,7.9807491107,5.9719606612,2.3142916928,5.9482457976,8.286252354
"226","06079","San Luis Obispo County","California",2602,2360,1367,289,242,1656,9.3183661702,8.4517079792,4.89554441,1.0349761042,0.8666581911,5.9305205142
"227","06081","San Mateo County","California",9172,4816,-2256,5754,4356,3498,12.043723496,6.3238740031,-2.962346294,7.5555587653,5.7198494928,4.5932124715
"228","06083","Santa Barbara County","California",5814,2998,-1173,1562,2816,389,13.185467411,6.7991109902,-2.660225881,3.5424320769,6.3863564204,0.8822061959
"229","06085","Santa Clara County","California",23703,9948,-11283,22163,13755,10880,12.441001295,5.2214099854,-5.922111868,11.632700996,7.2195913097,5.7105891276
"230","06087","Santa Cruz County","California",2983,1718,998,439,1265,1437,10.951511202,6.3073068204,3.663965196,1.6117041293,4.6442043817,5.2756693253
"231","06089","Shasta County","California",2093,2202,-650,229,-109,-421,11.716760061,12.326949668,-3.638745361,1.2819579809,-0.610189607,-2.35678738
"232","06091","Sierra County","California",16,27,27,0,-11,27,5.3547523427,9.0361445783,9.0361445783,0,-3.681392236,9.0361445783
"233","06093","Siskiyou County","California",399,502,48,18,-103,66,9.2025601107,11.578158335,1.1070749005,0.4151530877,-2.375598224,1.5222279882
"234","06095","Solano County","California",5282,3215,1406,1124,2067,2530,12.242963251,7.4519361706,3.2589182756,2.6052803284,4.7910270808,5.8641986039
"235","06097","Sonoma County","California",5070,4042,690,897,1028,1587,10.138489365,8.0827956634,1.3797944106,1.7937327338,2.0556937016,3.1735271445
"236","06099","Stanislaus County","California",7676,4186,882,880,3490,1762,14.457377481,7.8841300335,1.6612046559,1.6574377519,6.5732474479,3.3186424078
"237","06101","Sutter County","California",1307,800,-291,348,507,57,13.742127454,8.4114016549,-3.059647352,3.6589597199,5.3307257988,0.5993123679
"238","06103","Tehama County","California",816,677,179,-7,139,172,12.964934301,10.756446718,2.8440235784,-0.111218799,2.2084875832,2.7328047792
"239","06105","Trinity County","California",101,153,22,0,-52,22,7.7049242858,11.671815997,1.6783003395,0,-3.966891711,1.6783003395
"240","06107","Tulare County","California",7513,2906,-2835,430,4607,-2405,16.450533991,6.3630043628,-6.207542109,0.9415319601,10.087529628,-5.266010149
"241","06109","Tuolumne County","California",470,700,-98,58,-230,-40,8.7541209559,13.038052487,-1.825327348,1.0802957775,-4.283931532,-0.745031571
"242","06111","Ventura County","California",10317,5569,-2577,1874,4748,-703,12.210421169,6.5910473481,-3.049942362,2.2179247136,5.6193738209,-0.832017649
"243","06113","Yolo County","California",2411,1269,1049,1351,1142,2400,11.465364944,6.0346528886,4.9884561703,6.4245989381,5.4307120558,11.413055108
"244","06115","Yuba County","California",1196,601,-215,147,595,-68,16.201022723,8.1411493786,-2.912391209,1.9912628264,8.0598733448,-0.921128382
"245","08001","Adams County","Colorado",7370,2941,4976,1043,4429,6019,15.179741944,6.0574791124,10.248900396,2.1482321368,9.122262832,12.397132532
"246","08003","Alamosa County","Colorado",215,133,14,0,82,14,13.216942276,8.1760619659,0.8606381017,0,5.0408803098,0.8606381017
"247","08005","Arapahoe County","Colorado",8130,3747,4319,3115,4383,7434,13.013882275,5.9979110558,6.9135249133,4.9862537867,7.015971219,11.8997787
"248","08007","Archuleta County","Colorado",120,104,134,9,16,143,9.745797125,8.4463575083,10.88280679,0.7309347844,1.2994396167,11.613741574
"249","08009","Baca County","Colorado",30,56,-8,0,-26,-8,8.4033613445,15.68627451,-2.240896359,0,-7.282913165,-2.240896359
"250","08011","Bent County","Colorado",40,55,105,2,-15,107,6.8592986367,9.4315356255,18.005658921,0.3429649318,-2.572236989,18.348623853
"251","08013","Boulder County","Colorado",2866,1788,3494,1264,1078,4758,9.062837465,5.6539962971,11.048692988,3.997008568,3.4088411679,15.045701556
"252","08014","Broomfield County","Colorado",674,367,2619,110,307,2729,10.645607108,5.7966436328,41.366238894,1.7374136229,4.8489634748,43.103652517
"253","08015","Chaffee County","Colorado",138,203,205,1,-65,206,7.4487895717,10.957277413,11.065230885,0.053976736,-3.508487842,11.119207622
"254","08017","Cheyenne County","Colorado",28,20,-35,7,8,-28,15.246392595,10.890280425,-19.05799074,3.8115981487,4.3561121699,-15.24639259
"255","08019","Clear Creek County","Colorado",59,60,97,26,-1,123,6.4301672933,6.5391531797,10.571630974,2.8336330445,-0.108985886,13.405264018
"256","08021","Conejos County","Colorado",115,93,-193,4,22,-189,14.108698319,11.409642989,-23.67807631,0.4907373328,2.6990553306,-23.18733898
"257","08023","Costilla County","Colorado",30,34,12,7,-4,19,8.402184568,9.5224758437,3.3608738272,1.9605097325,-1.120291276,5.3213835597
"258","08025","Crowley County","Colorado",42,38,9,0,4,9,7.4792983706,6.76698424,1.6027067937,0,0.7123141305,1.6027067937
"259","08027","Custer County","Colorado",25,33,102,0,-8,102,5.6934639034,7.5153723525,23.229332726,0,-1.821908449,23.229332726
"260","08029","Delta County","Colorado",271,381,66,2,-110,68,9.0508316078,12.724600895,2.2042615724,0.0667958052,-3.673769287,2.2710573776
"261","08031","Denver County","Colorado",9363,4317,10785,2637,5046,13422,13.886180188,6.4025034575,15.995135462,3.9109107291,7.4836767307,19.906046191
"262","08033","Dolores County","Colorado",19,14,0,0,5,0,9.6008084891,7.0742799394,0,0,2.5265285498,0
"263","08035","Douglas County","Colorado",3371,1259,4553,698,2112,5251,10.591669311,3.955773261,14.305508862,2.1931133727,6.6358960502,16.498622235
"264","08037","Eagle County","Colorado",645,111,-82,126,534,44,12.03144965,2.0705285444,-1.529579645,2.350329699,9.9609211054,0.8207500536
"265","08039","Elbert County","Colorado",206,138,481,34,68,515,8.4679574136,5.6727093353,19.772269495,1.3976240391,2.7952480783,21.169893534
"266","08041","El Paso County","Colorado",9437,4128,3544,2050,5309,5594,14.112224862,6.17307028,5.2997483218,3.0655993396,7.9391545825,8.3653476614
"267","08043","Fremont County","Colorado",380,548,299,3,-168,302,8.2251082251,11.861471861,6.4718614719,0.0649350649,-3.636363636,6.5367965368
"268","08045","Garfield County","Colorado",764,344,121,22,420,143,13.291464062,5.9846382686,2.1050617166,0.3827384939,7.3068257931,2.4878002105
"269","08047","Gilpin County","Colorado",38,33,51,-2,5,49,6.575532099,5.710330507,8.8250562381,-0.346080637,0.865201592,8.4789756013
"270","08049","Grand County","Colorado",109,76,113,13,33,126,7.4453551913,5.1912568306,7.718579235,0.8879781421,2.2540983607,8.606557377
"271","08051","Gunnison County","Colorado",140,77,266,1,63,267,8.7445346658,4.8094940662,16.614615865,0.0624609619,3.9350405996,16.677076827
"272","08053","Hinsdale County","Colorado",7,7,-9,0,0,-9,9.1086532206,9.1086532206,-11.71112557,0,0,-11.71112557
"273","08055","Huerfano County","Colorado",56,103,59,0,-47,59,8.7479496993,16.089978911,9.2165898618,0,-7.342029212,9.2165898618
"274","08057","Jackson County","Colorado",12,10,-35,0,2,-35,8.7687248813,7.3072707344,-25.57544757,0,1.4614541469,-25.57544757
"275","08059","Jefferson County","Colorado",5844,4405,3931,744,1439,4675,10.395727861,7.8359310794,6.9927457601,1.3234807544,2.5597967817,8.3162265144
"276","08061","Kiowa County","Colorado",15,24,13,0,-9,13,10.853835022,17.366136035,9.4066570188,0,-6.512301013,9.4066570188
"277","08063","Kit Carson County","Colorado",115,77,151,2,38,153,14.166923314,9.4856790884,18.601786264,0.246381275,4.6812442254,18.848167539
"278","08065","Lake County","Colorado",85,43,86,-10,42,76,11.516054735,5.825768866,11.651537732,-1.354829969,5.6902858691,10.296707763
"279","08067","La Plata County","Colorado",580,358,590,2,222,592,10.701403175,6.6053488565,10.885910127,0.0369013903,4.0960543188,10.922811517
"280","08069","Larimer County","Colorado",3446,2254,7370,556,1192,7926,10.4842022,6.8576296454,22.422684333,1.6915892116,3.6265725543,24.114273545
"281","08071","Las Animas County","Colorado",126,178,29,23,-52,52,8.9721223342,12.67490298,2.0650122833,1.6377683626,-3.702780646,3.7027806459
"282","08073","Lincoln County","Colorado",74,65,30,2,9,32,13.394877364,11.765770658,5.4303556883,0.3620237126,1.6291067065,5.7923794009
"283","08075","Logan County","Colorado",219,186,-29,21,33,-8,10.064569498,8.5479905329,-1.332751212,0.9650957053,1.5165789655,-0.367655507
"284","08077","Mesa County","Colorado",1827,1489,624,-41,338,583,12.363850456,10.076504285,4.2227929309,-0.277459151,2.2873461709,3.94533378
"285","08079","Mineral County","Colorado",4,7,41,0,-3,41,5.5286800276,9.6751900484,56.668970283,0,-4.146510021,56.668970283
"286","08081","Moffat County","Colorado",192,96,-92,2,96,-90,14.842300557,7.4211502783,-7.111935683,0.1546072975,7.4211502783,-6.957328386
"287","08083","Montezuma County","Colorado",330,256,145,-13,74,132,12.881064835,9.9925836293,5.6598618213,-0.507435887,2.8884812054,5.1524259339
"288","08085","Montrose County","Colorado",452,464,3,-4,-12,-1,11.136845218,11.432513675,0.0739171143,-0.098556152,-0.295668457,-0.024639038
"289","08087","Morgan County","Colorado",455,264,-175,101,191,-74,16.147062477,9.3688450414,-6.210408645,3.5842929893,6.7782174353,-2.626115656
"290","08089","Otero County","Colorado",191,244,-102,-1,-53,-103,10.443721464,13.341717473,-5.577275337,-0.05467917,-2.897996008,-5.631954507
"291","08091","Ouray County","Colorado",20,26,37,2,-6,39,4.3568238754,5.663871038,8.0601241695,0.4356823875,-1.307047163,8.495806557
"292","08093","Park County","Colorado",115,90,317,3,25,320,6.9444444444,5.4347826087,19.142512077,0.1811594203,1.5096618357,19.323671498
"293","08095","Phillips County","Colorado",56,56,-78,11,0,-67,12.838147639,12.838147639,-17.88170564,2.5217790005,0,-15.35992664
"294","08097","Pitkin County","Colorado",127,54,45,103,73,148,7.1200313954,3.027414924,2.52284577,5.7745136514,4.0926164714,8.2973594214
"295","08099","Prowers County","Colorado",164,127,-178,19,37,-159,13.632585204,10.556940981,-14.79634248,1.5793848712,3.0756442228,-13.21695761
"296","08101","Pueblo County","Colorado",1876,1734,1428,61,142,1489,11.559162146,10.684214904,8.7987652153,0.3758576177,0.8749472413,9.174622833
"297","08103","Rio Blanco County","Colorado",84,53,-155,1,31,-154,12.797074954,8.0743449116,-23.61365021,0.1523461304,4.7227300427,-23.46130408
"298","08105","Rio Grande County","Colorado",128,130,-148,-3,-2,-151,11.196641008,11.371588523,-12.94611617,-0.262421274,-0.174947516,-13.20853744
"299","08107","Routt County","Colorado",213,101,114,112,112,226,8.782599732,4.1645191217,4.7005463354,4.6180806102,4.6180806102,9.3186269457
"300","08109","Saguache County","Colorado",78,60,31,4,18,35,12.531126998,9.6393284601,4.9803197044,0.6426218973,2.891798538,5.6229416017
"301","08111","San Juan County","Colorado",6,6,-24,0,0,-24,8.5775553967,8.5775553967,-34.31022159,0,0,-34.31022159
"302","08113","San Miguel County","Colorado",67,23,19,37,44,56,8.6007702182,2.9525032092,2.4390243902,4.7496790757,5.648267009,7.188703466
"303","08115","Sedgwick County","Colorado",22,54,71,2,-32,73,9.3457943925,22.939677145,30.161427358,0.849617672,-13.59388275,31.01104503
"304","08117","Summit County","Colorado",274,69,395,183,205,578,9.2168998924,2.3210441335,13.287136706,6.1558127018,6.8958557589,19.442949408
"305","08119","Teller County","Colorado",192,180,-53,-12,12,-65,8.2039011259,7.6911573055,-2.26461854,-0.51274382,0.5127438204,-2.77736236
"306","08121","Washington County","Colorado",47,50,56,1,-3,57,9.8760243749,10.506408909,11.767177979,0.2101281782,-0.630384535,11.977306157
"307","08123","Weld County","Colorado",4081,1725,6159,385,2356,6544,14.547204449,6.1489653697,21.954479833,1.3723777782,8.3982390789,23.326857611
"308","08125","Yuma County","Colorado",140,98,-205,28,42,-177,13.839462238,9.6876235666,-20.26492685,2.7678924476,4.1518386714,-17.4970344
"309","09001","Fairfield County","Connecticut",10188,6770,-7871,5356,3418,-2515,10.782914986,7.1653253291,-8.33061679,5.6687566414,3.6175896565,-2.661860148
"310","09003","Hartford County","Connecticut",9565,7995,-7762,5021,1570,-2741,10.664207897,8.9137838092,-8.654007496,5.598012321,1.7504240876,-3.055995175
"311","09005","Litchfield County","Connecticut",1413,1752,-1228,297,-339,-931,7.6475316009,9.4822897132,-6.646262425,1.607442948,-1.834758112,-5.038819477
"312","09007","Middlesex County","Connecticut",1365,1509,-1216,318,-144,-898,8.3193154392,9.1969575075,-7.411199688,1.9381262342,-0.877642068,-5.473073454
"313","09009","New Haven County","Connecticut",8802,7836,-7697,3977,966,-3720,10.215355762,9.0942430981,-8.932923574,4.6155953039,1.1211126637,-4.31732827
"314","09011","New London County","Connecticut",2674,2459,-2831,843,215,-1988,9.882072944,9.0875158449,-10.46228441,3.1154029513,0.7945570991,-7.346881456
"315","09013","Tolland County","Connecticut",1195,1030,-634,449,165,-185,7.8775194054,6.7898284415,-4.179370128,2.9598378352,1.0876909639,-1.219532293
"316","09015","Windham County","Connecticut",1117,1022,-747,353,95,-394,9.5782401592,8.7636181223,-6.4055017,3.0269639894,0.8146220368,-3.378537711
"317","10001","Kent County","Delaware",2254,1553,597,386,701,983,13.08232754,9.0136888507,3.4650175427,2.2403631013,4.0686386892,5.7053806441
"318","10003","New Castle County","Delaware",6579,4497,-985,1765,2082,780,11.91298577,8.1429848014,-1.783597961,3.1959902545,3.7700009688,1.4123922938
"319","10005","Sussex County","Delaware",2193,2483,4437,130,-290,4567,10.322112997,11.6870983,20.884275134,0.6118899634,-1.364985303,21.496165097
"320","11001","District of Columbia","District of Columbia",9652,4895,2865,5042,4757,7907,14.430016587,7.3181652709,4.2832570993,7.5379344834,7.1118513164,11.821191583
"321","12001","Alachua County","Florida",2912,1859,1283,1347,1053,2630,11.315856966,7.2239622598,4.9856608818,5.2343610349,4.0918947066,10.220021917
"322","12003","Baker County","Florida",313,238,155,4,75,159,11.492775707,8.7389157135,5.6913106538,0.146872533,2.7538599938,5.8381831868
"323","12005","Bay County","Florida",2398,1956,2106,514,442,2620,13.333629883,10.875971665,11.710018571,2.858000734,2.4576582187,14.568019305
"324","12007","Bradford County","Florida",285,283,186,3,2,189,10.694986491,10.619933954,6.9798859201,0.1125788052,0.0750525368,7.0924647253
"325","12009","Brevard County","Florida",5200,6996,10750,1327,-1796,12077,9.2725505755,12.47514689,19.169215132,2.3662835796,-3.202596314,21.535498712
"326","12011","Broward County","Florida",22155,14775,105,16647,7380,16752,11.825318351,7.8862143369,0.0560441628,8.8854016965,3.939104014,8.9414458593
"327","12013","Calhoun County","Florida",132,164,-13,5,-32,-8,9.1469752616,11.36442381,-0.900838473,0.3464763357,-2.217448548,-0.554362137
"328","12015","Charlotte County","Florida",1000,2503,5503,279,-1503,5782,5.8735081289,14.701390847,32.321915234,1.638708768,-8.827882718,33.960624002
"329","12017","Citrus County","Florida",1024,2573,2944,48,-1549,2992,7.3367151004,18.434929642,21.093055914,0.3439085203,-11.09821454,21.436964434
"330","12019","Clay County","Florida",2188,1703,2893,421,485,3314,10.913861302,8.4946553006,14.430439098,2.0999705705,2.4192060016,16.530409669
"331","12021","Collier County","Florida",3253,3134,6214,2390,119,8604,9.248926337,8.9105856563,17.667638567,6.7952456026,0.3383406806,24.462884169
"332","12023","Columbia County","Florida",853,748,294,17,105,311,12.545870379,11.001536979,4.3241335187,0.2500349314,1.5443333995,4.57416845
"333","12027","DeSoto County","Florida",371,325,47,217,46,264,10.451587458,9.1557032989,1.324055554,6.1131926642,1.2958841592,7.4372482182
"334","12029","Dixie County","Florida",145,223,388,-3,-78,385,8.953380673,13.769682001,23.958011732,-0.185242359,-4.816301328,23.772769373
"335","12031","Duval County","Florida",12819,7806,5127,3675,5013,8802,14.185590101,8.6381711777,5.6735720763,4.0667792823,5.5474189231,9.7403513587
"336","12033","Escambia County","Florida",3853,3341,23,889,512,912,12.483739225,10.82485667,0.0745201148,2.8803644358,1.6588825547,2.9548845505
"337","12035","Flagler County","Florida",814,1209,2745,110,-395,2855,7.8898139981,11.718409243,26.60631379,1.0661910808,-3.828595245,27.672504871
"338","12037","Franklin County","Florida",110,134,60,12,-24,72,9.4161958569,11.470638589,5.136106831,1.0272213662,-2.054442732,6.1633281972
"339","12039","Gadsden County","Florida",559,468,-191,36,91,-155,12.129760226,10.155148096,-4.144515569,0.7811652381,1.9746121298,-3.363350331
"340","12041","Gilchrist County","Florida",195,196,378,2,-1,380,11.351728956,11.40994295,22.004889976,0.1164279893,-0.058213995,22.121317965
"341","12043","Glades County","Florida",69,129,192,27,-60,219,5.2948624487,9.8990906649,14.733530292,2.0719026973,-4.604228216,16.805432989
"342","12045","Gulf County","Florida",112,183,-7,6,-71,-1,7.0157855174,11.463292408,-0.438486595,0.3758456527,-4.447506891,-0.062640942
"343","12047","Hamilton County","Florida",154,151,181,10,3,191,10.869181635,10.657444331,12.774817377,0.7057910153,0.2117373046,13.480608392
"344","12049","Hardee County","Florida",401,238,-279,20,163,-259,14.724782433,8.739397055,-10.24492344,0.7344031139,5.985385378,-9.510520325
"345","12051","Hendry County","Florida",580,276,56,460,304,516,14.903704084,7.0921074608,1.4389783254,11.820179101,7.8115966235,13.259157427
"346","12053","Hernando County","Florida",1517,2542,3320,299,-1025,3619,8.5883075599,14.391218073,18.795768687,1.6927514571,-5.802910513,20.488520145
"347","12055","Highlands County","Florida",938,1453,1605,512,-515,2117,9.4352908041,14.615647695,16.144607399,5.1501800551,-5.180356891,21.294787454
"348","12057","Hillsborough County","Florida",17289,10380,15190,9044,6909,24234,12.967954399,7.785723099,11.393558177,6.7836300296,5.1822312997,18.177188206
"349","12059","Holmes County","Florida",207,249,-250,-6,-42,-256,10.660212174,12.823153775,-12.87465238,-0.308991657,-2.162941601,-13.18364404
"350","12061","Indian River County","Florida",1233,2058,3482,315,-825,3797,8.4467386204,14.098449376,23.853644668,2.1579259249,-5.651710756,26.011570593
"351","12063","Jackson County","Florida",519,594,-79,51,-75,-28,10.661681629,12.202387066,-1.622876394,1.0476796976,-1.540705438,-0.575196697
"352","12065","Jefferson County","Florida",128,153,76,-2,-25,74,9.0931694668,10.869179128,5.3990693709,-0.142080773,-1.776009661,5.256988598
"353","12067","Lafayette County","Florida",64,63,-194,55,1,-139,7.2714878146,7.1578708175,-22.04169744,6.2489348407,0.1136169971,-15.7927626
"354","12069","Lake County","Florida",3156,3971,9650,726,-815,10376,9.8551240556,12.400094304,30.133696811,2.2670532523,-2.544970249,32.400750064
"355","12071","Lee County","Florida",6638,6624,18798,3073,14,21871,9.6420123307,9.6216766614,27.304993641,4.4636794053,0.0203356693,31.768673047
"356","12073","Leon County","Florida",3075,1818,246,748,1257,994,10.793601763,6.3813879694,0.8634881411,2.6255655672,4.412213794,3.4890537083
"357","12075","Levy County","Florida",404,560,436,14,-156,450,10.24068136,14.195003866,11.051824438,0.3548750966,-3.954322505,11.406699535
"358","12077","Liberty County","Florida",85,76,-16,1,9,-15,10.105813815,9.0357864701,-1.902270836,0.1188919272,1.0700273451,-1.783378909
"359","12079","Madison County","Florida",207,238,-116,20,-31,-96,11.166253102,12.838493904,-6.257417197,1.078865034,-1.672240803,-5.178552163
"360","12081","Manatee County","Florida",3577,3833,10497,1209,-256,11706,10.025800249,10.743330264,29.421533468,3.3886476101,-0.717530015,32.810181078
"361","12083","Marion County","Florida",3478,4788,4989,563,-1310,5552,10.223518207,14.074239556,14.665075427,1.6549283354,-3.850721349,16.320003763
"362","12085","Martin County","Florida",1261,1910,2883,211,-649,3094,8.1677067916,12.371387765,18.673670643,1.3666821039,-4.203680974,20.040352746
"363","12086","Miami-Dade County","Florida",32085,19256,-32032,46709,12829,14677,11.997655437,7.2004629296,-11.97783696,17.466058526,4.7971925075,5.4882215631
"364","12087","Monroe County","Florida",743,742,-12,425,1,413,9.7136880638,9.7006144594,-0.156883253,5.5562818669,0.0130736044,5.3993986142
"365","12089","Nassau County","Florida",748,793,1681,21,-45,1702,9.7027558161,10.286477757,21.805257389,0.2724035724,-0.583721941,22.077660961
"366","12091","Okaloosa County","Florida",2884,1795,1382,727,1089,2109,14.69658982,9.1471493508,7.0425406144,3.7047228847,5.5494404696,10.747263499
"367","12093","Okeechobee County","Florida",511,427,107,67,84,174,12.868781243,10.753365149,2.6946371684,1.6872961708,2.1154160948,4.3819333392
"368","12095","Orange County","Florida",16381,7495,11242,13513,8886,24755,12.860214159,5.884091638,8.8257449225,10.608636465,6.976122521,19.434381387
"369","12097","Osceola County","Florida",4172,2043,5019,5243,2129,10262,13.146057679,6.4375349566,15.814972074,16.520800674,6.7085227228,32.335772748
"370","12099","Palm Beach County","Florida",14565,14453,15487,9980,112,25467,10.316164044,10.236836178,10.969202372,7.0686795168,0.0793278663,18.037881889
"371","12101","Pasco County","Florida",4945,5915,11366,916,-970,12282,10.108505454,12.091366989,23.23423114,1.8724754289,-1.982861535,25.106706569
"372","12103","Pinellas County","Florida",8658,11882,11389,2731,-3224,14120,9.1908291279,12.613239974,12.089899854,2.8990707263,-3.422410846,14.98897058
"373","12105","Polk County","Florida",7520,6590,10402,2802,930,13204,11.719985849,10.270572705,16.211608085,4.3669415357,1.4494131435,20.578549621
"374","12107","Putnam County","Florida",836,977,99,18,-141,117,11.618937757,13.578591134,1.3759268396,0.2501685163,-1.959653378,1.6260953559
"375","12109","St. Johns County","Florida",2165,1820,7848,299,345,8147,9.7450312719,8.1921279052,35.325175714,1.3458495844,1.5529033666,36.671025299
"376","12111","St. Lucie County","Florida",2978,3125,6357,1004,-147,7361,10.136354044,10.63670463,21.637610026,3.4173604635,-0.500350586,25.05497049
"377","12113","Santa Rosa County","Florida",1819,1339,2886,163,480,3049,11.0611128,8.1422924901,17.549407115,0.9911827303,2.9188203101,18.540589845
"378","12115","Sarasota County","Florida",2965,5450,9733,1030,-2485,10763,7.4005942939,13.603115987,24.293417964,2.5708641223,-6.202521693,26.864282086
"379","12117","Seminole County","Florida",4576,3309,3695,1842,1267,5537,10.286625027,7.4384707637,8.3061799552,4.1407262456,2.8481542634,12.446906201
"380","12119","Sumter County","Florida",522,1597,5829,-19,-1075,5810,4.5526895319,13.928439047,50.838366439,-0.165710922,-9.375749515,50.672655518
"381","12121","Suwannee County","Florida",439,569,14,11,-130,25,10.039448859,13.01240638,0.3201646561,0.2515579441,-2.972957521,0.5717226002
"382","12123","Taylor County","Florida",223,286,-174,18,-63,-156,9.9245644095,12.728365117,-7.743830526,0.8010859165,-2.803800708,-6.942744609
"383","12125","Union County","Florida",145,249,108,10,-104,118,9.4976092225,16.309687561,7.0740813519,0.6550075326,-6.812078339,7.7290888845
"384","12127","Volusia County","Florida",4846,6843,10637,1353,-1997,11990,9.4675804725,13.36909888,20.781397748,2.6433422161,-3.901518408,23.424739964
"385","12129","Wakulla County","Florida",349,259,6,16,90,22,11.091336681,8.2311065912,0.190682006,0.5084853493,2.8602300896,0.6991673552
"386","12131","Walton County","Florida",768,595,1644,21,173,1665,12.36406372,9.5789295747,26.466823901,0.3380798673,2.7851341453,26.804903768
"387","12133","Washington County","Florida",241,261,262,18,-20,280,9.8647182825,10.683367103,10.724299544,0.7367839381,-0.81864882,11.461083482
"388","13001","Appling County","Georgia",258,218,-92,2,40,-90,13.984118811,11.816038375,-4.986585002,0.1084040218,2.1680804358,-4.878180981
"389","13003","Atkinson County","Georgia",120,64,60,9,56,69,14.491003502,7.7285352011,7.245501751,1.0868252626,6.7624683009,8.3323270136
"390","13005","Bacon County","Georgia",167,127,17,13,40,30,14.8994067,11.330686533,1.5167060713,1.1598340545,3.5687201677,2.6765401258
"391","13007","Baker County","Georgia",38,44,-90,-1,-6,-91,11.713933416,13.56350185,-27.74352651,-0.308261406,-1.849568434,-28.05178792
"392","13009","Baldwin County","Georgia",490,413,-476,23,77,-453,10.715535339,9.0316655003,-10.40937719,0.5029741078,1.683869839,-9.906403079
"393","13011","Banks County","Georgia",236,187,86,23,49,109,12.895822519,10.218300046,4.6993251551,1.2567962624,2.6775224721,5.9561214174
"394","13013","Barrow County","Georgia",1036,540,1526,63,496,1589,14.017332242,7.3063314774,20.647151545,0.852405339,6.7110007645,21.499556885
"395","13015","Bartow County","Georgia",1344,847,288,14,497,302,13.217288686,8.3296454738,2.8322761469,0.1376800905,4.8876432119,2.9699562374
"396","13017","Ben Hill County","Georgia",250,211,-133,-1,39,-134,14.382694742,12.138994362,-7.651593603,-0.057530779,2.2437003797,-7.709124382
"397","13019","Berrien County","Georgia",270,218,93,17,52,110,14.289494575,11.537443768,4.9219370204,0.8997089177,2.7520508071,5.8216459381
"398","13021","Bibb County","Georgia",2226,1671,-1133,199,555,-934,14.441370049,10.840758918,-7.350436777,1.291029937,3.6006111308,-6.05940684
"399","13023","Bleckley County","Georgia",142,136,-14,9,6,-5,11.177581864,10.705289673,-1.102015113,0.7084382872,0.4722921914,-0.393576826
"400","13025","Brantley County","Georgia",217,177,41,-12,40,29,11.804705562,9.6287229702,2.2303821569,-0.652794778,2.1759825921,1.5775873793
"401","13027","Brooks County","Georgia",191,201,134,21,-10,155,12.238490373,12.879249031,8.5861660206,1.3455931823,-0.640758658,9.9317592029
"402","13029","Bryan County","Georgia",540,232,747,64,308,811,15.775865847,6.7777794008,21.823281088,1.8697322485,8.9980864459,23.693013336
"403","13031","Bulloch County","Georgia",928,515,-48,124,413,76,12.727758995,7.0633576322,-0.658332362,1.7006919347,5.6644013633,1.0423595729
"404","13033","Burke County","Georgia",319,233,-76,2,86,-74,14.105682069,10.302896308,-3.360601371,0.0884368782,3.8027857617,-3.272164493
"405","13035","Butts County","Georgia",225,246,194,3,-21,197,9.6137412408,10.511023757,8.2891813365,0.1281832165,-0.897282516,8.4173645531
"406","13037","Calhoun County","Georgia",54,59,32,0,-5,32,8.2847499233,9.0518563977,4.909481436,0,-0.767106474,4.909481436
"407","13039","Camden County","Georgia",753,333,-18,147,420,129,14.426945626,6.3800436832,-0.344867226,2.81641568,8.0469019428,2.4715484538
"408","13043","Candler County","Georgia",126,143,11,15,-17,26,11.5990058,13.163951026,1.0126116174,1.3808340238,-1.564945227,2.3934456412
"409","13045","Carroll County","Georgia",1466,1075,32,116,391,148,12.836622025,9.4129390698,0.2801991165,1.0157217973,3.4236829547,1.2959209138
"410","13047","Catoosa County","Georgia",726,635,230,8,91,238,11.060666078,9.6742740486,3.5040677656,0.1218806179,1.386392029,3.6259483836
"411","13049","Charlton County","Georgia",111,104,82,92,7,174,8.4455603743,7.9129574679,6.2390626189,6.9999239139,0.5326029065,13.238986533
"412","13051","Chatham County","Georgia",4079,2397,1257,814,1682,2071,14.358732461,8.4378234147,4.4248410648,2.8654102042,5.9209090461,7.290251269
"413","13053","Chattahoochee County","Georgia",235,37,-1134,274,198,-860,20.635756937,3.249034071,-99.57850369,24.060414471,17.386722866,-75.51808922
"414","13055","Chattooga County","Georgia",299,332,67,7,-33,74,12.019617302,13.346197138,2.6933590609,0.2813957228,-1.326579836,2.9747547837
"415","13057","Cherokee County","Georgia",2807,1460,3467,337,1347,3804,12.057689623,6.2715450123,14.892771615,1.4476100474,5.7861446107,16.340381662
"416","13059","Clarke County","Georgia",1352,747,2024,465,605,2489,11.083557068,6.1238292378,16.592544012,3.8120222163,4.9597278298,20.404566229
"417","13061","Clay County","Georgia",42,37,2,-2,5,0,13.660757847,12.034477151,0.6505122784,-0.650512278,1.626280696,0
"418","13063","Clayton County","Georgia",4401,1644,2562,858,2757,3420,16.313715605,6.0940123734,9.4968732972,3.1804517131,10.219703232,12.67732501
"419","13065","Clinch County","Georgia",97,72,10,18,25,28,14.242713457,10.57191102,1.468320975,2.6429777549,3.6708024374,4.1112987299
"420","13067","Cobb County","Georgia",9750,4156,3414,2598,5594,6012,13.29174494,5.6656914843,4.6541556129,3.5417388056,7.626053456,8.1958944186
"421","13069","Coffee County","Georgia",572,397,-90,21,175,-69,13.317966449,9.2434137766,-2.095484231,0.4889463207,4.0745526723,-1.606537911
"422","13071","Colquitt County","Georgia",658,457,-643,53,201,-590,14.3979344,9.9997811864,-14.06971401,1.1597120413,4.3981532133,-12.91000197
"423","13073","Columbia County","Georgia",1721,884,3566,318,837,3884,12.159837209,6.2459593801,25.195804468,2.2468496412,5.9138778293,27.442654109
"424","13075","Cook County","Georgia",222,198,-253,-1,24,-254,12.919370326,11.522681642,-14.72342654,-0.058195362,1.3966886839,-14.7816219
"425","13077","Coweta County","Georgia",1639,959,2074,190,680,2264,11.99651596,7.0193159278,15.180460098,1.3906882443,4.9772000322,16.571148343
"426","13079","Crawford County","Georgia",142,114,-86,9,28,-77,11.445613187,9.1887317132,-6.93185024,0.7254261879,2.2568814734,-6.206424052
"427","13081","Crisp County","Georgia",314,239,-205,17,75,-188,13.648613405,10.38859428,-8.910718943,0.7389376684,3.2600191254,-8.171781274
"428","13083","Dade County","Georgia",162,201,-79,-6,-39,-85,9.9879774346,12.392490521,-4.870680354,-0.36992509,-2.404513086,-5.240605444
"429","13085","Dawson County","Georgia",216,212,308,18,4,326,9.3324692158,9.1596457118,13.307409808,0.777705768,0.172823504,14.085115576
"430","13087","Decatur County","Georgia",344,306,-152,-6,38,-158,12.686002987,11.284642192,-5.60544318,-0.221267494,1.4013607951,-5.826710674
"431","13089","DeKalb County","Georgia",11108,4380,-2013,5107,6728,3094,15.21842926,6.0007850342,-2.75789504,6.9968057465,9.2176442261,4.2389107068
"432","13091","Dodge County","Georgia",242,230,-51,2,12,-49,11.439646411,10.872391217,-2.410834574,0.0945425323,0.5672551939,-2.316292042
"433","13093","Dooly County","Georgia",97,130,-180,-2,-33,-182,6.8597291468,9.1934514338,-12.72939429,-0.141437714,-2.333722287,-12.87083201
"434","13095","Dougherty County","Georgia",1279,876,-1737,92,403,-1645,13.885948484,9.5106261705,-18.85839915,0.9988328855,4.3753223136,-17.85956627
"435","13097","Douglas County","Georgia",1745,963,1268,170,782,1438,12.53938769,6.9200173899,9.1117155248,1.2216022391,5.6193703,10.333317764
"436","13099","Early County","Georgia",131,135,10,0,-4,10,12.536484999,12.919278434,0.9569835877,0,-0.382793435,0.9569835877
"437","13101","Echols County","Georgia",59,29,-40,9,30,-31,14.61481298,7.1835521427,-9.908347783,2.2293782512,7.4312608373,-7.678969532
"438","13103","Effingham County","Georgia",760,424,1260,55,336,1315,13.510510644,7.5374427803,22.399004489,0.9777343229,5.9730678637,23.376738812
"439","13105","Elbert County","Georgia",217,236,-74,5,-19,-69,11.217948718,12.200165426,-3.8254756,0.2584780811,-0.982216708,-3.566997519
"440","13107","Emanuel County","Georgia",320,277,-51,2,43,-49,14.233925672,12.32124191,-2.268531904,0.0889620355,1.9126837622,-2.179569869
"441","13109","Evans County","Georgia",160,133,-146,-1,27,-147,14.877493142,12.366916175,-13.57571249,-0.092984332,2.5105769678,-13.66869682
"442","13111","Fannin County","Georgia",225,320,668,1,-95,669,9.3177347552,13.25188943,27.663319184,0.0414121545,-3.934154674,27.704731339
"443","13113","Fayette County","Georgia",929,834,648,247,95,895,8.4677786893,7.6018594476,5.9064807219,2.2513900283,0.8659192416,8.1578707502
"444","13115","Floyd County","Georgia",1170,1044,19,174,126,193,12.181789786,10.869904732,0.1978239367,1.8116507887,1.3118850539,2.0094747254
"445","13117","Forsyth County","Georgia",2351,1132,6728,528,1219,7256,11.36058876,5.4700920783,32.511289313,2.55142104,5.8904966815,35.062710353
"446","13119","Franklin County","Georgia",277,307,96,23,-30,119,12.466807687,13.817003466,4.3206264908,1.0351500968,-1.350195778,5.3557765876
"447","13121","Fulton County","Georgia",12794,6371,3384,3987,6423,7371,12.808108131,6.378025395,3.3877315863,3.9913965233,6.4300827361,7.3791281096
"448","13123","Gilmer County","Georgia",344,332,475,26,12,501,11.765510637,11.355085847,16.245981257,0.8892537109,0.4104247897,17.135234968
"449","13125","Glascock County","Georgia",21,43,34,2,-22,36,6.9744271006,14.280969777,11.291929591,0.6642311524,-7.306542677,11.956160744
"450","13127","Glynn County","Georgia",979,849,944,113,130,1057,11.827242525,10.256720024,11.404409544,1.3651464814,1.5705225008,12.769556025
"451","13129","Gordon County","Georgia",703,516,271,58,187,329,12.537451848,9.2024539877,4.8330717649,1.034384363,3.3349978599,5.8674561278
"452","13131","Grady County","Georgia",317,259,-239,42,58,-197,12.606880095,10.300258501,-9.504871744,1.6703121893,2.3066215948,-7.834559555
"453","13133","Greene County","Georgia",163,201,218,40,-38,258,9.8584734487,12.156767872,13.18495222,2.419257288,-2.298294424,15.604209508
"454","13135","Gwinnett County","Georgia",11757,4072,6185,3672,7685,9857,13.358117297,4.6265419439,7.0272990971,4.1720682756,8.7315753534,11.199367373
"455","13137","Habersham County","Georgia",463,421,133,47,42,180,10.59654182,9.6353004451,3.0439310195,1.0756748715,0.9612413746,4.119605891
"456","13139","Hall County","Georgia",2619,1478,1645,425,1141,2070,13.722926824,7.7443626751,8.6194023008,2.226897251,5.9785641491,10.846299552
"457","13141","Hancock County","Georgia",65,105,41,4,-40,45,7.5788491809,12.242756369,4.780504868,0.4663907188,-4.663907188,5.2468955868
"458","13143","Haralson County","Georgia",355,358,227,-7,-3,220,12.414540749,12.519452361,7.9383119722,-0.244793761,-0.104911612,7.6935182109
"459","13145","Harris County","Georgia",294,259,380,3,35,383,8.922474621,7.8602752614,11.53245019,0.0910456594,1.0621993596,11.62349585
"460","13147","Hart County","Georgia",256,285,72,17,-29,89,10.078144991,11.219809854,2.8344782788,0.6692518158,-1.141664862,3.5037300947
"461","13149","Heard County","Georgia",109,127,-47,0,-18,-47,9.4083121143,10.961978335,-4.056795132,0,-1.553666221,-4.056795132
"462","13151","Henry County","Georgia",2358,1416,2355,235,942,2590,10.977193693,6.5919025739,10.963227798,1.0939951306,4.3852911191,12.057222928
"463","13153","Houston County","Georgia",2026,1126,-569,380,900,-189,13.592161362,7.5541824744,-3.81734443,2.5493688635,6.0379788872,-1.267975566
"464","13155","Irwin County","Georgia",97,117,80,-2,-20,78,10.634215864,12.826837691,8.7704873102,-0.219262183,-2.192621828,8.5512251274
"465","13157","Jackson County","Georgia",798,569,1040,54,229,1094,12.713180765,9.064912099,16.568556385,0.8602904277,3.6482686655,17.428846813
"466","13159","Jasper County","Georgia",157,140,133,0,17,133,11.533516988,10.28466483,9.7704315886,0,1.2488521579,9.7704315886
"467","13161","Jeff Davis County","Georgia",203,156,33,4,47,37,13.553211377,10.415275738,2.2032314061,0.2670583522,3.1379356389,2.4702897583
"468","13163","Jefferson County","Georgia",205,228,-189,8,-23,-181,12.789718314,14.22466232,-11.7914964,0.4991109586,-1.434944006,-11.29238544
"469","13165","Jenkins County","Georgia",103,89,-181,-2,14,-183,11.496818841,9.9341444358,-20.20314767,-0.223239201,1.5626744056,-20.42638687
"470","13167","Johnson County","Georgia",85,87,-93,-3,-2,-96,8.7108013937,8.9157614265,-9.530641525,-0.307440049,-0.204960033,-9.838081574
"471","13169","Jones County","Georgia",308,266,-247,-1,42,-248,10.788846854,9.3176404652,-8.652094718,-0.035028724,1.4712063892,-8.687123441
"472","13171","Lamar County","Georgia",219,215,15,36,4,51,12.024048096,11.804430779,0.8235649381,1.9765558514,0.2196173168,2.8001207895
"473","13173","Lanier County","Georgia",148,99,-159,11,49,-148,14.347341379,9.5972080849,-15.41369783,1.0663564539,4.7501332946,-14.34734138
"474","13175","Laurens County","Georgia",630,522,-198,3,108,-195,13.247539743,10.97653293,-4.163512491,0.0630835226,2.271006813,-4.100428968
"475","13177","Lee County","Georgia",368,206,-128,22,162,-106,12.61937829,7.0641084992,-4.38934897,0.7544193543,5.5552697906,-3.634929616
"476","13179","Liberty County","Georgia",1520,350,-4143,446,1170,-3697,24.17552705,5.5667332024,-65.89421616,7.093608595,18.608793848,-58.80060757
"477","13181","Lincoln County","Georgia",88,87,74,2,1,76,11.456095815,11.325912908,9.6335351168,0.260365814,0.130182907,9.8939009308
"478","13183","Long County","Georgia",307,105,373,49,202,422,17.714945182,6.0588574726,21.523369879,2.8274668205,11.656087709,24.350836699
"479","13185","Lowndes County","Georgia",1626,864,-1222,281,762,-941,14.335084812,7.6171668371,-10.77335402,2.4773424551,6.7179179744,-8.296011567
"480","13187","Lumpkin County","Georgia",260,275,181,11,-15,192,8.3238622721,8.8040850955,5.7946887356,0.3521634038,-0.480222823,6.1468521394
"481","13189","McDuffie County","Georgia",265,240,-76,-6,25,-82,12.327588212,11.164608192,-3.535459261,-0.279115205,1.16298002,-3.814574466
"482","13191","McIntosh County","Georgia",114,146,2,0,-32,2,8.1144565449,10.392198733,0.1423588868,0,-2.277742188,0.1423588868
"483","13193","Macon County","Georgia",144,155,-122,7,-11,-115,10.466257223,11.265762983,-8.867245703,0.5087763928,-0.79950576,-8.35846931
"484","13195","Madison County","Georgia",353,297,-30,19,56,-11,12.440090217,10.466591486,-1.057231463,0.6695799267,1.9734987313,-0.387651537
"485","13197","Marion County","Georgia",86,83,-82,0,3,-82,10.006399442,9.6573389959,-9.540985514,0,0.3490604456,-9.540985514
"486","13199","Meriwether County","Georgia",280,263,-52,1,17,-51,13.210662892,12.408586931,-2.453408823,0.0471809389,0.8020759613,-2.406227884
"487","13201","Miller County","Georgia",64,91,-74,0,-27,-74,10.86034278,15.44204989,-12.55727134,0,-4.58170711,-12.55727134
"488","13205","Mitchell County","Georgia",281,262,-316,32,19,-284,12.4427126,11.601390396,-13.99251666,1.4169637124,0.8413222043,-12.57555295
"489","13207","Monroe County","Georgia",259,253,48,0,6,48,9.6981951621,9.4735265483,1.7973489104,0,0.2246686138,1.7973489104
"490","13209","Montgomery County","Georgia",79,108,-13,5,-29,-8,8.8130298974,12.048192771,-1.450245426,0.5577867024,-3.235162874,-0.892458724
"491","13211","Morgan County","Georgia",188,189,54,-2,-1,52,10.491364156,10.547169285,3.0134769385,-0.111610257,-0.055805128,2.9018666815
"492","13213","Murray County","Georgia",498,362,13,72,136,85,12.658549605,9.201596299,0.330444066,1.8301517501,3.4569533057,2.1605958161
"493","13215","Muscogee County","Georgia",3014,1798,-3912,758,1216,-3154,15.099216985,9.0074293758,-19.59792198,3.7973478681,6.091787609,-15.80057411
"494","13217","Newton County","Georgia",1304,862,937,92,442,1029,12.51373488,8.2721161551,8.9918478391,0.8828708657,4.2416187245,9.8747187049
"495","13219","Oconee County","Georgia",341,225,653,15,116,668,9.6153846154,6.3444619896,18.413038574,0.4229641326,3.2709226258,18.836002707
"496","13221","Oglethorpe County","Georgia",159,151,177,5,8,182,10.865851158,10.319141666,12.095947516,0.3416934327,0.5467094922,12.437640949
"497","13223","Paulding County","Georgia",1850,879,2076,102,971,2178,12.323433508,5.8552962453,13.828890791,0.6794541718,6.4681372631,14.508344963
"498","13225","Peach County","Georgia",306,238,-278,35,68,-243,11.358785427,8.8346108874,-10.31941944,1.2992074834,2.5241745392,-9.020211956
"499","13227","Pickens County","Georgia",318,283,294,-7,35,287,10.601413522,9.4345912788,9.8013068409,-0.233364449,1.166822243,9.5679423923
"500","13229","Pierce County","Georgia",237,198,60,-6,39,54,12.439312426,10.392336964,3.1491930193,-0.314919302,2.0469754625,2.8342737174
"501","13231","Pike County","Georgia",151,177,184,-1,-26,183,8.4636511406,9.9209685556,10.313323244,-0.05605067,-1.457317415,10.257272574
"502","13233","Polk County","Georgia",538,456,255,33,82,288,13.106127967,11.10853969,6.2120123266,0.8039074776,1.9975882776,7.0159198041
"503","13235","Pulaski County","Georgia",102,117,-96,-3,-15,-99,8.9051859612,10.214772132,-8.381351493,-0.261917234,-1.309586171,-8.643268727
"504","13237","Putnam County","Georgia",231,238,161,12,-7,173,10.877242548,11.206855959,7.5811084428,0.565051561,-0.329613411,8.1461600038
"505","13239","Quitman County","Georgia",20,26,-2,0,-6,-2,8.7527352298,11.378555799,-0.875273523,0,-2.625820569,-0.875273523
"506","13241","Rabun County","Georgia",148,212,117,7,-64,124,9.1383408972,13.09005588,7.2242289525,0.4322188262,-3.951714983,7.6564477787
"507","13243","Randolph County","Georgia",80,90,-155,-1,-10,-156,11.066537557,12.449854752,-21.44141652,-0.138331719,-1.383317195,-21.57974824
"508","13245","Richmond County","Georgia",2937,1888,-1278,410,1049,-868,14.593825078,9.3813897674,-6.350326336,2.0372721423,5.2124353104,-4.313054194
"509","13247","Rockdale County","Georgia",998,631,750,75,367,825,11.368555351,7.1879342948,8.5435035199,0.854350352,4.1806210557,9.3978538719
"510","13249","Schley County","Georgia",41,48,11,15,-7,26,7.8899259117,9.2369864332,2.1168093909,2.8865582604,-1.347060522,5.0033676513
"511","13251","Screven County","Georgia",161,168,61,3,-7,64,11.477454999,11.976474782,4.3486009624,0.2138656211,-0.499019783,4.5624665835
"512","13253","Seminole County","Georgia",92,134,4,0,-42,4,10.722610723,15.617715618,0.4662004662,0,-4.895104895,0.4662004662
"513","13255","Spalding County","Georgia",829,749,44,16,80,60,13.001882058,11.747176913,0.6900878294,0.2509410289,1.2547051443,0.9410288582
"514","13257","Stephens County","Georgia",303,337,77,8,-34,85,11.906633134,13.242690978,3.0257780572,0.3143665514,-1.336057843,3.3401446086
"515","13259","Stewart County","Georgia",52,69,-85,144,-17,59,8.8016249154,11.679079215,-14.3872715,24.373730535,-2.877454299,9.9864590386
"516","13261","Sumter County","Georgia",374,342,-533,10,32,-523,12.092993177,11.058298574,-17.23413199,0.3233420636,1.0346946034,-16.91078992
"517","13263","Talbot County","Georgia",50,91,7,0,-41,7,7.6893502499,13.994617455,1.076509035,0,-6.305267205,1.076509035
"518","13265","Taliaferro County","Georgia",12,26,-39,1,-14,-38,7.1920887024,15.582858855,-23.37428828,0.5993407252,-8.390770153,-22.77494756
"519","13267","Tattnall County","Georgia",254,266,33,35,-12,68,10.014390758,10.487511582,1.3010822639,1.3799357344,-0.473120823,2.6810179983
"520","13269","Taylor County","Georgia",88,100,-124,1,-12,-123,10.587102984,12.030798845,-14.91819057,0.1203079885,-1.443695861,-14.79788258
"521","13271","Telfair County","Georgia",133,152,-54,53,-19,-1,8.0855979087,9.2406833242,-3.282874339,3.2220803696,-1.155085416,-0.060793969
"522","13273","Terrell County","Georgia",104,105,-64,0,-1,-64,11.491712707,11.602209945,-7.071823204,0,-0.110497238,-7.071823204
"523","13275","Thomas County","Georgia",568,486,-66,43,82,-23,12.682676313,10.851726563,-1.473691262,0.9601321856,1.8309497494,-0.513559076
"524","13277","Tift County","Georgia",603,409,-123,13,194,-110,14.89072725,10.100012347,-3.037412026,0.3210272873,4.7907149031,-2.716384739
"525","13279","Toombs County","Georgia",418,327,-61,-3,91,-64,15.391696585,12.040872687,-2.246156679,-0.110466722,3.3508238976,-2.356623401
"526","13281","Towns County","Georgia",77,154,198,2,-77,200,6.9092377406,13.818475481,17.766611333,0.1794607205,-6.909237741,17.946072053
"527","13283","Treutlen County","Georgia",82,72,-25,6,10,-19,12.048192771,10.57890097,-3.673229503,0.8815750808,1.4692918014,-2.791654423
"528","13285","Troup County","Georgia",996,689,-101,113,307,12,14.343834383,9.9225922592,-1.454545455,1.6273627363,4.4212421242,0.1728172817
"529","13287","Turner County","Georgia",100,143,-38,-1,-43,-39,12.467273407,17.828200972,-4.737563895,-0.124672734,-5.360927565,-4.862236629
"530","13289","Twiggs County","Georgia",85,102,-45,17,-17,-28,10.161994142,12.19439297,-5.379879252,2.0323988284,-2.032398828,-3.347480423
"531","13291","Union County","Georgia",180,309,374,9,-129,383,8.2238720731,14.117647059,17.087378641,0.4111936037,-5.893774986,17.498572244
"532","13293","Upson County","Georgia",361,367,75,1,-6,76,13.774945625,14.00389209,2.8618308086,0.0381577441,-0.228946465,2.8999885527
"533","13295","Walker County","Georgia",779,772,-137,15,7,-122,11.353202652,11.251184143,-1.996647963,0.2186110909,0.1020185091,-1.778036872
"534","13297","Walton County","Georgia",1040,830,577,55,210,632,11.826312408,9.4383070179,6.5613290956,0.6254299831,2.3880053901,7.1867590787
"535","13299","Ware County","Georgia",476,441,-221,21,35,-200,13.430393319,12.442864398,-6.235539755,0.5925173523,0.9875289205,-5.643022403
"536","13301","Warren County","Georgia",55,90,-50,1,-35,-49,10.148537688,16.606698035,-9.225943353,0.1845188671,-6.458160347,-9.041424486
"537","13303","Washington County","Georgia",232,228,178,2,4,180,11.238676549,11.044906264,8.622777697,0.0968851427,0.1937702853,8.7196628397
"538","13305","Wayne County","Georgia",403,330,-581,21,73,-560,13.588468347,11.127033634,-19.59032285,0.7080839585,2.461434713,-18.88223889
"539","13307","Webster County","Georgia",35,20,3,0,15,3,13.351134846,7.6292199123,1.1443829868,0,5.7219149342,1.1443829868
"540","13309","Wheeler County","Georgia",66,72,-68,0,-6,-68,8.319152959,9.0754395916,-8.571248503,0,-0.756286633,-8.571248503
"541","13311","White County","Georgia",266,293,365,16,-27,381,9.4337949746,10.39136063,12.944869044,0.5674463143,-0.957565655,13.512315358
"542","13313","Whitfield County","Georgia",1385,767,-163,99,618,-64,13.393677411,7.4172928332,-1.576295609,0.9573819954,5.9763845774,-0.618913613
"543","13315","Wilcox County","Georgia",77,103,34,0,-26,34,8.6570352465,11.580190005,3.822586992,0,-2.923154759,3.822586992
"544","13317","Wilkes County","Georgia",115,153,-33,32,-38,-1,11.583983883,15.411735079,-3.324099723,3.2233694284,-3.827751196,-0.100730295
"545","13319","Wilkinson County","Georgia",97,124,-179,0,-27,-179,10.563572012,13.503947727,-19.49360196,0,-2.940375715,-19.49360196
"546","13321","Worth County","Georgia",243,221,-345,3,22,-342,11.647414082,10.592915688,-16.53645209,0.1437952356,1.0544983943,-16.39265686
"547","15001","Hawaii County","Hawaii",2374,1630,1058,405,744,1463,12.184450198,8.3659030428,5.430138294,2.0786446211,3.8185471557,7.5087829151
"548","15003","Honolulu County","Hawaii",12996,7676,-7462,5886,5320,-1576,13.133985653,7.7575002981,-7.541228143,5.9484948873,5.3764853551,-1.592733256
"549","15005","Kalawao County","Hawaii",0,1,0,0,-1,0,0,11.299435028,0,0,-11.29943503,0
"550","15007","Kauai County","Hawaii",894,539,121,281,355,402,12.64515764,7.6238702103,1.7114810676,3.9745965289,5.0212874298,5.6860775966
"551","15009","Maui County","Hawaii",1951,1223,-551,817,728,266,11.928854867,7.4776983608,-3.368938509,4.9953226171,4.4511565058,1.6263841079
"552","16001","Ada County","Idaho",5187,2849,3831,1330,2338,5161,12.082642761,6.636485295,8.923964607,3.0981135284,5.4461574657,12.022078135
"553","16003","Adams County","Idaho",28,38,17,1,-10,18,7.2062797581,9.7799511002,4.3752412817,0.2573671342,-2.573671342,4.6326084159
"554","16005","Bannock County","Idaho",1294,696,-345,435,598,90,15.427719821,8.2980625931,-4.113263785,5.1862891207,7.129657228,1.0730253353
"555","16007","Bear Lake County","Idaho",83,66,-65,1,17,-64,14.061838204,11.181702668,-11.01228293,0.1694197374,2.8801355358,-10.84286319
"556","16009","Benewah County","Idaho",111,139,-14,2,-28,-12,12.318277661,15.425590944,-1.553656642,0.2219509488,-3.107313284,-1.331705693
"557","16011","Bingham County","Idaho",724,376,-565,51,348,-514,16.036325378,8.3282573786,-12.51453569,1.1296306551,7.7080679993,-11.38490503
"558","16013","Blaine County","Idaho",230,111,-35,94,119,59,10.6711207,5.149975642,-1.623866193,4.3612406338,5.5211450576,2.7373744403
"559","16015","Boise County","Idaho",44,48,183,-1,-4,182,6.4041918347,6.9863910924,26.63561604,-0.145549814,-0.582199258,26.490066225
"560","16017","Bonner County","Idaho",392,421,313,14,-29,327,9.4599160191,10.159756745,7.553453352,0.3378541435,-0.699840726,7.8913074955
"561","16019","Bonneville County","Idaho",2013,829,355,133,1184,488,18.451977194,7.598951363,3.2540744679,1.2191321246,10.853025831,4.4732065925
"562","16021","Boundary County","Idaho",139,114,291,1,25,292,12.505060501,10.2559489,26.179659035,0.089964464,2.2491116009,26.269623499
"563","16023","Butte County","Idaho",33,24,-105,3,9,-102,12.631578947,9.1866028708,-40.19138756,1.1483253589,3.4449760766,-39.0430622
"564","16025","Camas County","Idaho",9,5,11,0,4,11,8.4705882353,4.7058823529,10.352941176,0,3.7647058824,10.352941176
"565","16027","Canyon County","Idaho",3187,1413,2549,42,1774,2591,15.568821322,6.9026496795,12.452125997,0.2051743005,8.666171643,12.657300297
"566","16029","Caribou County","Idaho",81,67,-79,6,14,-73,11.90913769,9.8507682129,-11.61508491,0.8821583474,2.0583694773,-10.73292656
"567","16031","Cassia County","Idaho",367,208,-204,26,159,-178,15.611042579,8.8476753584,-8.677527755,1.1059594198,6.7633672211,-7.571568336
"568","16033","Clark County","Idaho",7,7,-5,2,0,-3,7.8784468205,7.8784468205,-5.627462015,2.2509848059,0,-3.376477209
"569","16035","Clearwater County","Idaho",55,108,38,2,-53,40,6.4184852375,12.603571012,4.4345898004,0.2333994632,-6.185085774,4.6679892636
"570","16037","Custer County","Idaho",36,41,-69,1,-5,-68,8.7912087912,10.012210012,-16.84981685,0.2442002442,-1.221001221,-16.60561661
"571","16039","Elmore County","Idaho",464,181,-917,191,283,-726,17.838606743,6.9585944408,-35.25431548,7.3430471724,10.880012302,-27.91126831
"572","16041","Franklin County","Idaho",206,96,-52,-15,110,-67,15.929477266,7.4234457161,-4.021033096,-1.159913393,8.5060315496,-5.180946489
"573","16043","Fremont County","Idaho",203,109,-108,12,94,-96,15.844520762,8.507649079,-8.429597253,0.936621917,7.3368716828,-7.492975336
"574","16045","Gem County","Idaho",190,193,26,15,-3,41,11.402508552,11.582548161,1.5603432755,0.9001980436,-0.180039609,2.4605413191
"575","16047","Gooding County","Idaho",197,132,45,3,65,48,12.998152547,8.7094220111,2.9691211401,0.1979414093,4.2887305358,3.1670625495
"576","16049","Idaho County","Idaho",150,203,73,6,-53,79,9.2114959469,12.466224515,4.4829280275,0.3684598379,-3.254728568,4.8513878654
"577","16051","Jefferson County","Idaho",465,171,-122,19,294,-103,17.200880389,6.3254850463,-4.512919156,0.7028316718,10.875395343,-3.810087484
"578","16053","Jerome County","Idaho",400,176,-241,69,224,-172,17.407197876,7.6591670656,-10.48783672,3.0027416337,9.7480308107,-7.485095087
"579","16055","Kootenai County","Idaho",1803,1336,2402,-33,467,2369,12.185272918,9.0291317909,16.233513893,-0.223024962,3.1561411275,16.010488932
"580","16057","Latah County","Idaho",465,206,-246,269,259,23,12.02964726,5.3292630871,-6.364071454,6.9590862642,6.7003841726,0.5950148107
"581","16059","Lemhi County","Idaho",68,106,54,-4,-38,50,8.7974642603,13.713694288,6.9862216185,-0.517497898,-4.916230028,6.4687237208
"582","16061","Lewis County","Idaho",40,38,-36,15,2,-21,10.515247108,9.9894847529,-9.463722397,3.9432176656,0.5257623554,-5.520504732
"583","16063","Lincoln County","Idaho",67,30,-75,10,37,-65,12.602275933,5.6428101194,-14.1070253,1.8809367065,6.959465814,-12.22608859
"584","16065","Madison County","Idaho",1155,128,-1060,99,1027,-961,30.439194086,3.373347916,-27.93553743,2.6090737788,27.06584617,-25.32646365
"585","16067","Minidoka County","Idaho",306,166,-49,13,140,-36,15.000367656,8.1374543494,-2.402019657,0.6372705213,6.8629133067,-1.764749136
"586","16069","Nez Perce County","Idaho",473,457,128,20,16,148,11.850033195,11.449186406,3.2067743107,0.5010584861,0.4008467888,3.7078327968
"587","16071","Oneida County","Idaho",42,40,65,6,2,71,9.9703264095,9.4955489614,15.430267062,1.4243323442,0.4747774481,16.854599407
"588","16073","Owyhee County","Idaho",143,103,-43,1,40,-42,12.661029705,9.1194829342,-3.807162778,0.0885386693,3.5415467706,-3.718624109
"589","16075","Payette County","Idaho",316,220,-31,-22,96,-53,13.876081324,9.6605629473,-1.361261143,-0.966056295,4.215518377,-2.327317437
"590","16077","Power County","Idaho",146,77,-120,11,69,-109,18.915592408,9.9760316124,-15.54706225,1.4251473732,8.9395607955,-14.12191488
"591","16079","Shoshone County","Idaho",145,158,60,17,-13,77,11.670020121,12.716297787,4.8289738431,1.3682092555,-1.046277666,6.1971830986
"592","16081","Teton County","Idaho",149,47,157,26,102,183,14.073199528,4.4391971665,14.828807556,2.4557260921,9.6340023613,17.284533648
"593","16083","Twin Falls County","Idaho",1238,766,532,238,472,770,15.169151973,9.3857596216,6.5185693456,2.9162020756,5.7833923517,9.4347714212
"594","16085","Valley County","Idaho",81,91,263,-5,-10,258,8.1653225806,9.1733870968,26.512096774,-0.504032258,-1.008064516,26.008064516
"595","16087","Washington County","Idaho",104,104,-55,-3,0,-58,10.474895503,10.474895503,-5.539608199,-0.302160447,0,-5.841768646
"596","17001","Adams County","Illinois",828,828,-155,44,0,-111,12.373907196,12.373907196,-2.316371516,0.6575506239,0,-1.658820892
"597","17003","Alexander County","Illinois",99,103,-321,0,-4,-321,14.303257964,14.881167377,-46.37723037,0,-0.577909413,-46.37723037
"598","17005","Bond County","Illinois",164,188,-376,8,-24,-368,9.7170789513,11.139090505,-22.27818101,0.4740038513,-1.422011554,-21.80417716
"599","17007","Boone County","Illinois",607,401,-362,20,206,-342,11.309224377,7.4711679988,-6.744545675,0.3726268329,3.8380563784,-6.371918842
"600","17009","Brown County","Illinois",56,49,-97,2,7,-95,8.2468154039,7.2159634784,-14.2846624,0.2945291216,1.0308519255,-13.99013327
"601","17011","Bureau County","Illinois",364,388,-371,20,-24,-351,10.809045152,11.521729447,-11.0169114,0.5939035798,-0.712684296,-10.42300782
"602","17013","Calhoun County","Illinois",50,54,-63,0,-4,-63,10.22181335,11.039558418,-12.87948482,0,-0.817745068,-12.87948482
"603","17015","Carroll County","Illinois",164,191,-118,2,-27,-116,11.147741563,12.983040479,-8.020936002,0.1359480678,-1.835298916,-7.884987935
"604","17017","Cass County","Illinois",184,160,-310,39,24,-271,14.187131347,12.336635954,-23.90223216,3.0070550137,1.850495393,-20.89517715
"605","17019","Champaign County","Illinois",2428,1281,-1784,1901,1147,117,11.639696735,6.1410426349,-8.552396613,9.1132880945,5.4986541001,0.5608914819
"606","17021","Christian County","Illinois",341,424,-268,-4,-83,-272,10.138700998,12.60647866,-7.968245945,-0.118929044,-2.467777662,-8.087174989
"607","17023","Clark County","Illinois",177,200,-156,1,-23,-155,11.091963027,12.533291556,-9.775967413,0.0626664578,-1.441328529,-9.713300956
"608","17025","Clay County","Illinois",165,164,-45,1,1,-44,12.291418355,12.216924911,-3.352205006,0.0744934446,0.0744934446,-3.277711561
"609","17027","Clinton County","Illinois",451,390,-45,3,61,-42,11.978115372,10.35801551,-1.195155636,0.0796770424,1.6200998619,-1.115478593
"610","17029","Coles County","Illinois",531,541,-433,76,-10,-357,10.145010604,10.336065417,-8.27267343,1.4520165836,-0.191054814,-6.820656846
"611","17031","Cook County","Illinois",69508,40738,-57384,18546,28770,-38838,13.233137331,7.755820173,-10.92493458,3.5308419885,5.4773171579,-7.394092589
"612","17033","Crawford County","Illinois",217,258,13,3,-41,16,11.260151,13.387644968,0.6745712581,0.1556702903,-2.127493968,0.8302415484
"613","17035","Cumberland County","Illinois",115,123,-56,1,-8,-55,10.558207859,11.292691884,-5.141388175,0.0918105031,-0.734484025,-5.049577672
"614","17037","DeKalb County","Illinois",1219,721,-1121,194,498,-927,11.680496733,6.9086449091,-10.74145762,1.8589141642,4.7718518235,-8.882543455
"615","17039","De Witt County","Illinois",176,199,-9,0,-23,-9,10.865203568,12.285088125,-0.555607001,0,-1.419884557,-0.555607001
"616","17041","Douglas County","Illinois",254,198,-129,0,56,-129,12.785020386,9.9662757336,-6.493179645,0,2.8187446519,-6.493179645
"617","17043","DuPage County","Illinois",10935,6172,-7755,3082,4763,-4673,11.709056449,6.608897705,-8.303953614,3.3001657043,5.1001587442,-5.003787909
"618","17045","Edgar County","Illinois",165,235,-139,7,-70,-132,9.3199277,13.273836421,-7.851333032,0.3953908721,-3.953908721,-7.45594216
"619","17047","Edwards County","Illinois",69,77,-111,0,-8,-111,10.504681434,11.722615513,-16.89883535,0,-1.217934079,-16.89883535
"620","17049","Effingham County","Illinois",448,383,5,24,65,29,13.113218593,11.210631074,0.1463528861,0.7024938532,1.902587519,0.8488467393
"621","17051","Fayette County","Illinois",256,237,-57,1,19,-56,11.60866115,10.74708083,-2.584740959,0.0453463326,0.8615803197,-2.539394626
"622","17053","Ford County","Illinois",142,204,49,1,-62,50,10.493256974,15.074819878,3.6209126178,0.0738961759,-4.581562904,3.6948087936
"623","17055","Franklin County","Illinois",513,575,3,9,-62,12,13.014524006,14.587429441,0.0761083275,0.2283249826,-1.572905435,0.3044333101
"624","17057","Fulton County","Illinois",339,452,-181,12,-113,-169,9.4564626135,12.608616818,-5.049025761,0.3347420394,-3.152154204,-4.714283722
"625","17059","Gallatin County","Illinois",64,84,-37,0,-20,-37,12.188154637,15.996952961,-7.0462769,0,-3.808798324,-7.0462769
"626","17061","Greene County","Illinois",130,170,-31,1,-40,-30,9.7163571135,12.706005456,-2.316977466,0.0747412086,-2.989648343,-2.242236257
"627","17063","Grundy County","Illinois",629,423,-135,6,206,-129,12.498385542,8.4051146017,-2.682483384,0.1192214837,4.0932709408,-2.5632619
"628","17065","Hamilton County","Illinois",90,99,-56,1,-9,-55,10.86759645,11.954356095,-6.762060013,0.1207510717,-1.086759645,-6.641308942
"629","17067","Hancock County","Illinois",219,199,-132,4,20,-128,11.987191768,10.892471058,-7.225156682,0.2189441419,1.0947207094,-7.00621254
"630","17069","Hardin County","Illinois",22,65,-39,-1,-43,-40,5.3573602825,15.828564471,-9.497138683,-0.243516376,-10.47120419,-9.740655059
"631","17071","Henderson County","Illinois",74,92,4,2,-18,6,10.565391205,13.135351228,0.5711022273,0.2855511136,-2.569960023,0.8566533409
"632","17073","Henry County","Illinois",579,561,-210,8,18,-202,11.641232885,11.279329272,-4.222208818,0.1608460502,0.361903613,-4.061362768
"633","17075","Iroquois County","Illinois",302,406,-99,7,-104,-92,10.551877151,14.18563617,-3.459059066,0.244579934,-3.633759019,-3.214479132
"634","17077","Jackson County","Illinois",729,468,-610,231,261,-379,12.293008667,7.8918080335,-10.28633098,3.8953155037,4.401200634,-6.39101548
"635","17079","Jasper County","Illinois",124,95,-40,7,29,-33,12.875759306,9.864493017,-4.153470744,0.7268573802,3.0112662894,-3.426613364
"636","17081","Jefferson County","Illinois",524,438,-210,38,86,-172,13.669505785,11.426037278,-5.478237051,0.9913000378,2.2434685067,-4.486937013
"637","17083","Jersey County","Illinois",190,260,-193,17,-70,-176,8.50302081,11.635712687,-8.637279033,0.7607965988,-3.132691877,-7.876482435
"638","17085","Jo Daviess County","Illinois",191,258,-204,8,-67,-196,8.6006979624,11.617696724,-9.186085782,0.3602386581,-3.016998762,-8.825847124
"639","17087","Johnson County","Illinois",102,128,-86,0,-26,-86,7.9470198675,9.9727308142,-6.700428516,0,-2.025710947,-6.700428516
"640","17089","Kane County","Illinois",6767,3162,-919,670,3605,-249,12.824084339,5.9922793971,-1.74158911,1.2697113207,6.831804942,-0.471877789
"641","17091","Kankakee County","Illinois",1335,1109,-418,52,226,-366,11.937495808,9.9166163682,-3.73773277,0.4649811101,2.0208794402,-3.27275166
"642","17093","Kendall County","Illinois",1621,575,339,156,1046,495,13.267853489,4.7063638224,2.7747084101,1.2768569675,8.5614896665,4.0515653775
"643","17095","Knox County","Illinois",577,710,-539,100,-133,-439,11.16939933,13.743974912,-10.43380631,1.9357711144,-2.574575582,-8.498035192
"644","17097","Lake County","Illinois",7929,4506,-5278,2198,3423,-3080,11.249896248,6.3932441032,-7.488580199,3.1185864489,4.856652145,-4.36999375
"645","17099","LaSalle County","Illinois",1234,1356,-557,37,-122,-520,11.082571444,12.178255169,-5.002424874,0.332297523,-1.095683725,-4.670127351
"646","17101","Lawrence County","Illinois",192,217,-80,1,-25,-79,11.631781419,13.146336292,-4.846575591,0.0605821949,-1.514554872,-4.785993397
"647","17103","Lee County","Illinois",333,377,-353,6,-44,-347,9.5939152105,10.861579683,-10.17012633,0.1728633371,-1.267664472,-9.997262997
"648","17105","Livingston County","Illinois",398,422,-452,33,-24,-419,10.808902408,11.460695518,-12.27543691,0.8962155263,-0.65179311,-11.37922138
"649","17107","Logan County","Illinois",327,368,-358,9,-41,-349,11.098666124,12.490241998,-12.15083325,0.305467875,-1.391575875,-11.84536537
"650","17109","McDonough County","Illinois",264,329,-385,83,-65,-302,8.3515232039,10.407769447,-12.17930467,2.62566828,-2.056246243,-9.553636392
"651","17111","McHenry County","Illinois",3331,2066,-1200,169,1265,-1031,10.831393156,6.718000078,-3.902032959,0.5495363084,4.1133930778,-3.352496651
"652","17113","McLean County","Illinois",2091,1180,-2666,757,911,-1909,12.04212151,6.7956496324,-15.35356095,4.35958201,5.2464718772,-10.99397894
"653","17115","Macon County","Illinois",1382,1336,-1275,64,46,-1211,12.80323138,12.377074619,-11.8119537,0.5929137542,0.4261567608,-11.21903994
"654","17117","Macoupin County","Illinois",450,550,-233,5,-100,-228,9.7742156192,11.946263535,-5.060871643,0.1086023958,-2.172047915,-4.952269247
"655","17119","Madison County","Illinois",3132,2891,-833,64,241,-769,11.759250742,10.854404181,-3.127540188,0.2402912029,0.9048465609,-2.887248985
"656","17121","Marion County","Illinois",528,533,-213,27,-5,-186,13.727835266,13.857833706,-5.537933545,0.7019915761,-0.12999844,-4.835941969
"657","17123","Marshall County","Illinois",142,159,-23,2,-17,-21,11.89379345,13.3176983,-1.926459502,0.1675182176,-1.42390485,-1.758941285
"658","17125","Mason County","Illinois",123,183,-183,0,-60,-183,8.7973393413,13.088724386,-13.08872439,0,-4.291385045,-13.08872439
"659","17127","Massac County","Illinois",158,231,-114,-1,-73,-115,10.778361416,15.75823726,-7.776792414,-0.068217477,-4.979875844,-7.845009892
"660","17129","Menard County","Illinois",97,125,-119,-3,-28,-122,7.8037007241,10.056315366,-9.573612228,-0.241351569,-2.252614642,-9.814963797
"661","17131","Mercer County","Illinois",137,175,-121,2,-38,-119,8.6588294779,11.060548603,-7.64757932,0.1264062698,-2.401719125,-7.52117305
"662","17133","Monroe County","Illinois",356,322,164,1,34,165,10.582639715,9.5719381688,4.8751486326,0.0297265161,1.0107015458,4.9048751486
"663","17135","Montgomery County","Illinois",279,359,-184,0,-80,-184,9.5166626872,12.245454856,-6.276221987,0,-2.728792168,-6.276221987
"664","17137","Morgan County","Illinois",386,394,-35,40,-8,5,11.134026566,11.364783593,-1.009561994,1.1537851364,-0.230757027,0.144223142
"665","17139","Moultrie County","Illinois",194,212,7,3,-18,10,13.157002374,14.377755171,0.4747371991,0.2034587996,-1.220752798,0.6781959986
"666","17141","Ogle County","Illinois",519,521,-406,30,-2,-376,10.026854195,10.065493325,-7.843743359,0.5795869477,-0.03863913,-7.264156411
"667","17143","Peoria County","Illinois",2704,1865,-2214,340,839,-1874,14.458230738,9.9721155054,-11.83821111,1.8179727999,4.4861152327,-10.02023831
"668","17145","Perry County","Illinois",201,268,42,4,-67,46,9.3366778149,12.448903753,1.9509476031,0.1858045336,-3.112225938,2.1367521368
"669","17147","Piatt County","Illinois",189,182,-68,1,7,-67,11.539518271,11.112128705,-4.151784351,0.0610556522,0.4273895656,-4.090728699
"670","17149","Pike County","Illinois",178,200,-143,-1,-22,-144,11.213657983,12.599615712,-9.008725234,-0.062998079,-1.385957728,-9.071723312
"671","17151","Pope County","Illinois",31,44,-72,0,-13,-72,7.161007161,10.164010164,-16.63201663,0,-3.003003003,-16.63201663
"672","17153","Pulaski County","Illinois",63,96,-110,3,-33,-107,11.006289308,16.77148847,-19.21733054,0.5241090147,-5.765199161,-18.69322152
"673","17155","Putnam County","Illinois",62,61,-108,2,1,-106,10.726643599,10.553633218,-18.68512111,0.3460207612,0.1730103806,-18.33910035
"674","17157","Randolph County","Illinois",311,403,-258,10,-92,-248,9.4321025097,12.222306468,-7.824702404,0.3032830389,-2.790203958,-7.521419365
"675","17159","Richland County","Illinois",205,219,-54,5,-14,-49,12.82412186,13.699915548,-3.378061368,0.31278346,-0.875793688,-3.065277908
"676","17161","Rock Island County","Illinois",1881,1595,-1617,516,286,-1101,12.823222235,10.873492539,-11.02347175,3.5176941379,1.9497296966,-7.505777608
"677","17163","St. Clair County","Illinois",3429,2464,-2318,230,965,-2088,12.921897699,9.2853764742,-8.735187771,0.8667356287,3.6365212247,-7.868452142
"678","17165","Saline County","Illinois",370,360,-8,1,10,-7,15.107282118,14.698977196,-0.326643938,0.0408304922,0.4083049221,-0.285813445
"679","17167","Sangamon County","Illinois",2334,1967,-910,259,367,-651,11.726757506,9.8828329113,-4.572129105,1.3012982837,1.843924595,-3.270830821
"680","17169","Schuyler County","Illinois",70,87,-103,7,-17,-96,9.7161496287,12.075785967,-14.29662017,0.9716149629,-2.359636338,-13.32500521
"681","17171","Scott County","Illinois",53,66,-47,1,-13,-46,10.310281101,12.839217975,-9.143079467,0.1945336057,-2.528936874,-8.948545861
"682","17173","Shelby County","Illinois",251,269,-267,2,-18,-265,11.427530788,12.247034988,-12.15597897,0.0910560222,-0.8195042,-12.06492294
"683","17175","Stark County","Illinois",58,89,-67,0,-31,-67,10.44386423,16.025929594,-12.06446385,0,-5.582065364,-12.06446385
"684","17177","Stephenson County","Illinois",526,545,-613,28,-19,-585,11.442867243,11.856202752,-13.33550878,0.6091260129,-0.413335509,-12.72638277
"685","17179","Tazewell County","Illinois",1549,1448,-1227,47,101,-1180,11.48883936,10.739728466,-9.100584826,0.3485961588,0.7491108944,-8.751988667
"686","17181","Union County","Illinois",196,237,-80,5,-41,-75,11.297806727,13.66112344,-4.611349684,0.2882093553,-2.363316713,-4.323140329
"687","17183","Vermilion County","Illinois",1015,1033,-624,30,-18,-594,12.770588642,12.997062136,-7.851081096,0.3774558219,-0.226473493,-7.473625274
"688","17185","Wabash County","Illinois",140,135,-12,34,5,22,12.055455093,11.624903126,-1.033324722,2.9277533798,0.4305519676,1.8944286575
"689","17187","Warren County","Illinois",214,191,-332,51,23,-281,12.164274549,10.856899247,-18.87167827,2.8989626261,1.307375302,-15.97271565
"690","17189","Washington County","Illinois",170,155,-148,3,15,-145,11.866122221,10.819111437,-10.3305064,0.2094021568,1.0470107842,-10.12110425
"691","17191","Wayne County","Illinois",200,226,-53,8,-26,-45,12.079847794,13.650228007,-3.201159665,0.4831939118,-1.570380213,-2.717965754
"692","17193","White County","Illinois",165,236,3,2,-71,5,11.592777348,16.581184571,0.21077777,0.1405185133,-4.988407223,0.3512962833
"693","17195","Whiteside County","Illinois",643,593,-149,-1,50,-150,11.287335539,10.40962671,-2.61557231,-0.017554177,0.8777088289,-2.633126487
"694","17197","Will County","Illinois",7925,4321,-3410,569,3604,-2841,11.556597067,6.3010796122,-4.972617792,0.8297417957,5.2555174548,-4.142875996
"695","17199","Williamson County","Illinois",826,739,-116,65,87,-51,12.250648869,10.960326288,-1.720430108,0.964034112,1.2903225806,-0.756395996
"696","17201","Winnebago County","Illinois",3643,3040,-2587,419,603,-2168,12.649371438,10.555610533,-8.982685674,1.4548686886,2.093760905,-7.527816985
"697","17203","Woodford County","Illinois",426,416,-145,13,10,-132,10.923076923,10.666666667,-3.717948718,0.3333333333,0.2564102564,-3.384615385
"698","18001","Adams County","Indiana",650,325,-134,3,325,-131,18.644408112,9.3222040559,-3.843616441,0.0860511144,9.3222040559,-3.757565327
"699","18003","Allen County","Indiana",5274,3231,-164,517,2043,353,14.395244165,8.8189294458,-0.447633683,1.4111378903,5.5763147192,0.9635042075
"700","18005","Bartholomew County","Indiana",1084,742,211,424,342,635,13.385029511,9.1620773961,2.6053885857,5.2354727978,4.2229521152,7.8408613834
"701","18007","Benton County","Indiana",112,94,-47,1,18,-46,12.867647059,10.799632353,-5.399816176,0.1148897059,2.0680147059,-5.284926471
"702","18009","Blackford County","Indiana",149,175,-88,5,-26,-83,12.122198267,14.237481186,-7.159419111,0.4067851767,-2.115282919,-6.752633934
"703","18011","Boone County","Indiana",768,537,1135,27,231,1162,12.322206445,8.6159177878,18.210552494,0.4332025703,3.7062886573,18.643755064
"704","18013","Brown County","Indiana",110,147,90,-1,-37,89,7.3482748255,9.8199672668,6.0122248572,-0.066802498,-2.471692441,5.9454223588
"705","18015","Carroll County","Indiana",194,204,-58,4,-10,-54,9.7411563857,10.243277849,-2.912304486,0.2008485853,-0.502121463,-2.711455901
"706","18017","Cass County","Indiana",503,427,-521,59,76,-462,13.13161639,11.147515305,-13.60153507,1.540289,1.9841010847,-12.06124607
"707","18019","Clark County","Indiana",1471,1182,516,-15,289,501,12.85400956,10.328646703,4.5089523676,-0.131074197,2.5253628571,4.3778781709
"708","18021","Clay County","Indiana",322,342,-10,-1,-20,-11,12.193736509,12.951111448,-0.378687469,-0.037868747,-0.757374938,-0.416556216
"709","18023","Clinton County","Indiana",490,388,-189,-2,102,-191,15.111330414,11.965706532,-5.828656017,-0.0616789,3.1456238821,-5.890334916
"710","18025","Crawford County","Indiana",135,109,-140,0,26,-140,12.719649503,10.269939228,-13.19074763,0,2.4497102747,-13.19074763
"711","18027","Daviess County","Indiana",543,348,-57,-4,195,-61,16.582177976,10.627252183,-1.740670616,-0.122152324,5.9549257925,-1.86282294
"712","18029","Dearborn County","Indiana",506,474,18,-12,32,6,10.235352422,9.588057407,0.3641034458,-0.242735631,0.6472950148,0.1213678153
"713","18031","Decatur County","Indiana",341,240,-188,10,101,-178,12.928909953,9.0995260664,-7.127962085,0.3791469194,3.8293838863,-6.748815166
"714","18033","DeKalb County","Indiana",562,451,-33,-11,111,-44,13.245657451,10.629522261,-0.777769922,-0.259256641,2.6161351906,-1.037026562
"715","18035","Delaware County","Indiana",1186,1236,-779,116,-50,-663,10.213528188,10.64411538,-6.708548448,0.9989622849,-0.430587192,-5.709586163
"716","18037","Dubois County","Indiana",571,422,-171,41,149,-130,13.496903513,9.9749444523,-4.041979861,0.9691296743,3.5219590602,-3.072850187
"717","18039","Elkhart County","Indiana",3183,1728,88,29,1455,117,15.737948084,8.543881335,0.435105068,0.1433868974,7.1940667491,0.5784919654
"718","18041","Fayette County","Indiana",248,311,9,7,-63,16,10.589918227,13.280099067,0.3843115486,0.2989089822,-2.69018084,0.6832205308
"719","18043","Floyd County","Indiana",861,766,323,-4,95,319,11.284699468,10.03958164,4.2334006134,-0.052426014,1.2451178275,4.1809745996
"720","18045","Fountain County","Indiana",202,214,-148,1,-12,-147,12.160982511,12.883417116,-8.91002679,0.0602028837,-0.722434605,-8.849823907
"721","18047","Franklin County","Indiana",245,219,-73,19,26,-54,10.667711667,9.5356279799,-3.17854266,0.8272919252,1.1320836871,-2.351250735
"722","18049","Fulton County","Indiana",263,240,-205,-2,23,-207,12.877637957,11.751456691,-10.03770259,-0.097928806,1.1261812662,-10.1356314
"723","18051","Gibson County","Indiana",406,383,-123,0,23,-123,12.057674888,11.374604636,-3.652940914,0,0.6830702523,-3.652940914
"724","18053","Grant County","Indiana",766,836,-802,14,-70,-788,11.279468716,12.310229565,-11.8095743,0.2061521698,-1.030760849,-11.60342213
"725","18055","Greene County","Indiana",341,378,-195,3,-37,-192,10.482953672,11.620400258,-5.994650927,0.0922253989,-1.137446586,-5.902425528
"726","18057","Hamilton County","Indiana",3831,1597,2936,469,2234,3405,12.533574997,5.2247766302,9.6054753827,1.5343896303,7.3087983668,11.139865013
"727","18059","Hancock County","Indiana",782,621,499,-2,161,497,10.851314785,8.6172205648,6.9243044474,-0.027752723,2.2340942205,6.8965517241
"728","18061","Harrison County","Indiana",471,382,252,18,89,270,11.970873416,9.7088612421,6.4047985157,0.4574856083,2.2620121742,6.862284124
"729","18063","Hendricks County","Indiana",1724,1112,1176,167,612,1343,10.996090137,7.0926057034,7.5008132259,1.065166504,3.9034844339,8.5659797299
"730","18065","Henry County","Indiana",464,577,-115,3,-113,-112,9.5130702204,11.829830856,-2.357765249,0.0615069195,-2.316760636,-2.296258329
"731","18067","Howard County","Indiana",989,1076,-179,13,-87,-166,11.992094191,13.047010464,-2.170459919,0.1576311673,-1.054916274,-2.012828752
"732","18069","Huntington County","Indiana",443,389,-151,4,54,-147,12.116405011,10.639461736,-4.129971008,0.1094032055,1.4769432744,-4.020567803
"733","18071","Jackson County","Indiana",618,496,-28,91,122,63,14.111361016,11.325623081,-0.63934969,2.0778864926,2.7857379351,1.4385368026
"734","18073","Jasper County","Indiana",402,364,-66,2,38,-64,11.999820898,10.86550947,-1.970119849,0.0597006015,1.1343114282,-1.910419247
"735","18075","Jay County","Indiana",330,246,-85,1,84,-84,15.613910575,11.63946061,-4.021764845,0.0473148805,3.9744499645,-3.974449965
"736","18077","Jefferson County","Indiana",371,374,-105,5,-3,-100,11.46813805,11.56087232,-3.245699448,0.1545571166,-0.09273427,-3.091142332
"737","18079","Jennings County","Indiana",347,298,-129,-2,49,-131,12.449770379,10.691733639,-4.628300804,-0.071756602,1.7580367394,-4.700057405
"738","18081","Johnson County","Indiana",1801,1314,1185,222,487,1407,12.164932438,8.8754698629,8.0041337805,1.499508607,3.2894625748,9.5036423875
"739","18083","Knox County","Indiana",437,476,-167,9,-39,-158,11.541915377,12.571971898,-4.410754847,0.237705351,-1.030056521,-4.173049496
"740","18085","Kosciusko County","Indiana",1110,707,-260,37,403,-223,14.145984006,9.0100997228,-3.313473731,0.4715328002,5.1358842833,-2.841940931
"741","18087","LaGrange County","Indiana",729,266,-278,-6,463,-284,18.923023011,6.904697011,-7.216187102,-0.155745045,12.018326,-7.371932147
"742","18089","Lake County","Indiana",5987,4903,-4241,63,1084,-4178,12.232497129,10.017693908,-8.665111128,0.1287201134,2.2148032217,-8.536391015
"743","18091","LaPorte County","Indiana",1318,1261,-948,4,57,-944,11.842400827,11.330248439,-8.517902871,0.0359405184,0.5121523878,-8.481962352
"744","18093","Lawrence County","Indiana",509,565,-27,6,-56,-21,11.160445102,12.388313326,-0.592007893,0.1315573097,-1.227868223,-0.460450584
"745","18095","Madison County","Indiana",1510,1502,-373,15,8,-358,11.654516897,11.592771112,-2.87889722,0.1157733467,0.0617457849,-2.763123874
"746","18097","Marion County","Indiana",14592,7932,-5173,2531,6660,-2642,15.566003771,8.4614543525,-5.518293415,2.6999421289,7.1045494185,-2.818351286
"747","18099","Marshall County","Indiana",581,458,-349,34,123,-315,12.405384919,9.7791158227,-7.451771664,0.7259605633,2.6262690965,-6.725811101
"748","18101","Martin County","Indiana",124,107,-37,-1,17,-38,12.124175018,10.461989734,-3.617697385,-0.097775605,1.6621852848,-3.715472989
"749","18103","Miami County","Indiana",365,387,-62,13,-22,-49,10.128760129,10.739260739,-1.720501721,0.3607503608,-0.610500611,-1.35975136
"750","18105","Monroe County","Indiana",1349,929,-374,774,420,400,9.3801063867,6.4596877933,-2.600563224,5.3819142649,2.9204185933,2.7813510413
"751","18107","Montgomery County","Indiana",458,399,32,13,59,45,11.991726233,10.446940539,0.8378498678,0.3403765088,1.5447856937,1.1782263766
"752","18109","Morgan County","Indiana",768,662,-67,19,106,-48,11.044003451,9.5197008916,-0.963474259,0.2732240437,1.5243025597,-0.690250216
"753","18111","Newton County","Indiana",130,172,-80,5,-42,-75,9.2678405931,12.262066016,-5.703286519,0.3564554074,-2.994225422,-5.346831111
"754","18113","Noble County","Indiana",653,464,-42,10,189,-32,13.760259612,9.7775811023,-0.885039669,0.2107237307,3.9826785093,-0.674315938
"755","18115","Ohio County","Indiana",41,65,-56,0,-24,-56,6.918079811,10.967687505,-9.44908462,0,-4.049607694,-9.44908462
"756","18117","Orange County","Indiana",222,237,-133,8,-15,-125,11.274186176,12.035955513,-6.754354781,0.4062769793,-0.761769336,-6.348077802
"757","18119","Owen County","Indiana",227,245,-181,4,-18,-177,10.847490025,11.707643419,-8.64932024,0.1911451987,-0.860153394,-8.458175041
"758","18121","Parke County","Indiana",214,156,-333,-1,58,-334,12.510961707,9.1201403099,-19.46799182,-0.058462438,3.3908213973,-19.52645425
"759","18123","Perry County","Indiana",215,201,-37,0,14,-37,11.128652398,10.403995963,-1.915163436,0,0.7246564352,-1.915163436
"760","18125","Pike County","Indiana",133,162,-63,7,-29,-56,10.677156505,13.005258299,-5.05760045,0.5619556055,-2.328101794,-4.495644844
"761","18127","Porter County","Indiana",1764,1522,-101,54,242,-47,10.545603458,9.0988710107,-0.603801559,0.3228245956,1.4467324472,-0.280976963
"762","18129","Posey County","Indiana",274,261,-5,4,13,-1,10.702288884,10.194516053,-0.195297242,0.1562377939,0.5077728302,-0.039059448
"763","18131","Pulaski County","Indiana",132,144,-112,2,-12,-110,10.266780742,11.200124446,-8.711207902,0.155557284,-0.933343704,-8.555650618
"764","18133","Putnam County","Indiana",350,341,-221,22,9,-199,9.3138363692,9.0743377197,-5.881022393,0.5854411432,0.2394986495,-5.29558125
"765","18135","Randolph County","Indiana",307,281,-228,6,26,-222,12.167330519,11.13687256,-9.036323643,0.2377979906,1.0304579593,-8.798525652
"766","18137","Ripley County","Indiana",311,301,14,15,10,29,10.966536197,10.613914454,0.4936704397,0.528932614,0.3526217427,1.0226030537
"767","18139","Rush County","Indiana",199,209,-129,2,-10,-127,11.861123529,12.457159887,-7.688869021,0.1192072716,-0.596036358,-7.569661749
"768","18141","St. Joseph County","Indiana",3502,2659,-790,426,843,-364,13.068334478,9.9225303759,-2.948025196,1.5896945995,3.1458041019,-1.358330597
"769","18143","Scott County","Indiana",272,312,52,19,-40,71,11.504462209,13.196294886,2.1993824811,0.8036205219,-1.691832678,3.003003003
"770","18145","Shelby County","Indiana",512,432,-106,20,80,-86,11.539588451,9.7365277559,-2.389055422,0.4507651739,1.8030606955,-1.938290248
"771","18147","Spencer County","Indiana",246,190,-177,0,56,-177,11.884919197,9.1794091359,-8.5513443,0,2.7055100611,-8.5513443
"772","18149","Starke County","Indiana",285,297,-80,-1,-12,-81,12.442698101,12.966601179,-3.492687186,-0.04365859,-0.523903078,-3.536345776
"773","18151","Steuben County","Indiana",389,330,-76,-5,59,-81,11.274055182,9.5641085092,-2.202643172,-0.144910735,1.7099466728,-2.347553907
"774","18153","Sullivan County","Indiana",227,267,-79,-2,-40,-81,10.844898837,12.755894226,-3.774215895,-0.095549769,-1.91099539,-3.869765664
"775","18155","Switzerland County","Indiana",130,120,33,5,10,38,12.30361537,11.357183419,3.1232254401,0.4732159758,0.9464319515,3.5964414159
"776","18157","Tippecanoe County","Indiana",2383,1192,-242,1383,1191,1141,12.837745017,6.4215661187,-1.303707215,7.4505251193,6.4161788988,6.1468179039
"777","18159","Tipton County","Indiana",150,182,-130,5,-32,-125,9.7853741275,11.872920608,-8.480657577,0.3261791376,-2.087546481,-8.15447844
"778","18161","Union County","Indiana",80,72,-55,-9,8,-64,11.09108554,9.981976986,-7.625121309,-1.247747123,1.109108554,-8.872868432
"779","18163","Vanderburgh County","Indiana",2243,1985,-777,48,258,-729,12.345067477,10.925082007,-4.276467869,0.2641833432,1.4199854699,-4.012284525
"780","18165","Vermillion County","Indiana",164,228,-8,7,-64,-1,10.496,14.592,-0.512,0.448,-4.096,-0.064
"781","18167","Vigo County","Indiana",1289,1145,-634,118,144,-516,11.960324014,10.624182309,-5.882735008,1.0948938974,1.3361417053,-4.78784111
"782","18169","Wabash County","Indiana",325,421,-147,1,-96,-146,10.162601626,13.164477799,-4.596622889,0.0312695435,-3.001876173,-4.565353346
"783","18171","Warren County","Indiana",85,90,-64,0,-5,-64,10.235414534,10.837497742,-7.706665061,0,-0.602083208,-7.706665061
"784","18173","Warrick County","Indiana",686,552,396,62,134,458,11.199634298,9.0119506302,6.4650950173,1.0122118461,2.1876836675,7.4773068634
"785","18175","Washington County","Indiana",326,302,-135,0,24,-135,11.711663164,10.849454833,-4.849921862,0,0.8622083311,-4.849921862
"786","18177","Wayne County","Indiana",815,911,-332,19,-96,-313,12.133212249,13.562400441,-4.942609162,0.2828601629,-1.429188191,-4.659748999
"787","18179","Wells County","Indiana",327,315,8,13,12,21,11.749276898,11.318110774,0.2874440831,0.4670966351,0.4311661247,0.7545407183
"788","18181","White County","Indiana",275,312,-140,18,-37,-122,11.2903888,12.809459293,-5.747834298,0.7390072669,-1.519070493,-5.008827031
"789","18183","Whitley County","Indiana",393,322,-73,12,71,-61,11.748878924,9.6263079223,-2.182361734,0.3587443946,2.1225710015,-1.823617339
"790","19001","Adair County","Iowa",63,125,-167,0,-62,-167,8.6848635236,17.231872071,-23.02178109,0,-8.547008547,-23.02178109
"791","19003","Adams County","Iowa",41,63,-103,0,-22,-103,10.747051114,16.513761468,-26.99868938,0,-5.766710354,-26.99868938
"792","19005","Allamakee County","Iowa",181,167,-235,18,14,-217,12.96747385,11.964464823,-16.83622295,1.2895830348,1.0030090271,-15.54663992
"793","19007","Appanoose County","Iowa",142,181,-61,1,-39,-60,11.250643743,14.340609278,-4.833023016,0.0792298855,-3.089965535,-4.753793131
"794","19009","Audubon County","Iowa",69,72,-56,1,-3,-55,12.016718913,12.539184953,-9.752699408,0.1741553466,-0.52246604,-9.578544061
"795","19011","Benton County","Iowa",319,240,-103,4,79,-99,12.455342327,9.3707904652,-4.021630908,0.1561798411,3.0845518615,-3.865451067
"796","19013","Black Hawk County","Iowa",1775,1189,-592,324,586,-268,13.29020568,8.9025659456,-4.432564373,2.4259305016,4.3876397343,-2.006633872
"797","19015","Boone County","Iowa",286,279,164,-12,7,152,10.843807466,10.578399591,6.2181273579,-0.454984929,0.265407875,5.7631424292
"798","19017","Bremer County","Iowa",267,228,9,29,39,38,10.808622609,9.2298350369,0.3643355936,1.1739702459,1.5787875721,1.5383058395
"799","19019","Buchanan County","Iowa",286,216,-103,10,70,-93,13.537179912,10.223884129,-4.87527808,0.4733279689,3.3132957826,-4.401950111
"800","19021","Buena Vista County","Iowa",303,196,-443,90,107,-353,14.779406385,9.5602760774,-21.60817501,4.3899226886,5.2191303075,-17.21825232
"801","19023","Butler County","Iowa",157,192,-51,11,-35,-40,10.519615398,12.864752588,-3.417199906,0.737043117,-2.345137191,-2.680156789
"802","19025","Calhoun County","Iowa",119,145,-23,5,-26,-18,12.115041995,14.762025961,-2.341562739,0.509035378,-2.646983965,-1.832527361
"803","19027","Carroll County","Iowa",275,250,-108,4,25,-104,13.441845688,12.219859716,-5.278979397,0.1955177555,1.2219859716,-5.083461642
"804","19029","Cass County","Iowa",129,193,19,0,-64,19,9.6495493137,14.436922617,1.4212514493,0,-4.787373303,1.4212514493
"805","19031","Cedar County","Iowa",195,200,-23,10,-5,-13,10.645266951,10.918222513,-1.255595589,0.5459111257,-0.272955563,-0.709684463
"806","19033","Cerro Gordo County","Iowa",485,532,-202,26,-47,-176,11.2543364,12.344962814,-4.687373099,0.6033252503,-1.090626414,-4.084047848
"807","19035","Cherokee County","Iowa",129,164,-292,7,-35,-285,11.078191421,14.083902271,-25.07621624,0.6011421701,-3.005710851,-24.47507407
"808","19037","Chickasaw County","Iowa",125,138,-102,15,-13,-87,10.246321571,11.311939014,-8.360998402,1.2295585885,-1.065617443,-7.131439813
"809","19039","Clarke County","Iowa",128,105,-11,3,23,-8,13.909263787,11.40994295,-1.195327357,0.32599837,2.4993208367,-0.869328987
"810","19041","Clay County","Iowa",212,206,2,8,6,10,12.855496938,12.491662119,0.121278273,0.485113092,0.363834819,0.606391365
"811","19043","Clayton County","Iowa",191,198,-44,8,-7,-36,10.761169643,11.15555806,-2.479012902,0.4507296186,-0.394388416,-2.028283284
"812","19045","Clinton County","Iowa",591,565,-404,28,26,-376,12.384225305,11.83940321,-8.465697163,0.5867314865,0.5448220946,-7.878965676
"813","19047","Crawford County","Iowa",212,165,-219,93,47,-126,12.373420492,9.630256515,-12.78197683,5.427962763,2.743163977,-7.354014066
"814","19049","Dallas County","Iowa",1254,426,1784,239,828,2023,15.83733266,5.3801465016,22.530942157,3.0184389997,10.457186158,25.549381157
"815","19051","Davis County","Iowa",139,69,-48,0,70,-48,15.857623638,7.8717700074,-5.476013918,0,7.9858536307,-5.476013918
"816","19053","Decatur County","Iowa",93,81,-94,7,12,-87,11.383108935,9.9143206854,-11.50550796,0.8567931457,1.4687882497,-10.64871481
"817","19055","Delaware County","Iowa",232,186,-56,7,46,-49,13.340617004,10.695494667,-3.220148932,0.4025186165,2.6451223369,-2.817630315
"818","19057","Des Moines County","Iowa",444,453,-238,17,-9,-221,11.106663998,11.331799079,-5.953572143,0.4252551531,-0.225135081,-5.52831699
"819","19059","Dickinson County","Iowa",174,184,166,8,-10,174,10.28216871,10.873097947,9.8094253213,0.472743389,-0.590929236,10.28216871
"820","19061","Dubuque County","Iowa",1236,952,62,69,284,131,12.783980721,9.8465612023,0.6412676413,0.7136688266,2.9374195183,1.354936468
"821","19063","Emmet County","Iowa",109,115,-122,6,-6,-116,11.169749449,11.784598043,-12.5019214,0.6148485935,-0.614848594,-11.88707281
"822","19065","Fayette County","Iowa",209,267,-111,20,-58,-91,10.339368754,13.20866726,-5.491243692,0.9894132779,-2.869298506,-4.501830415
"823","19067","Floyd County","Iowa",198,202,-105,18,-4,-87,12.409513961,12.660211212,-6.580802858,1.1281376328,-0.250697252,-5.452665225
"824","19069","Franklin County","Iowa",124,108,-137,12,16,-125,11.946050096,10.404624277,-13.19845857,1.1560693642,1.5414258189,-12.04238921
"825","19071","Fremont County","Iowa",81,102,-100,2,-21,-98,11.618733415,14.630997633,-14.34411533,0.2868823065,-3.012264219,-14.05723302
"826","19073","Greene County","Iowa",105,116,-169,-1,-11,-170,11.624688624,12.842513147,-18.71021312,-0.11071132,-1.217824523,-18.82092444
"827","19075","Grundy County","Iowa",123,144,36,0,-21,36,9.9213551119,11.615245009,2.9038112523,0,-1.693889897,2.9038112523
"828","19077","Guthrie County","Iowa",115,146,-10,9,-31,-1,10.779397291,13.685147865,-0.937338895,0.8436050054,-2.905750574,-0.093733889
"829","19079","Hamilton County","Iowa",193,167,-36,18,26,-18,12.681516525,10.973125698,-2.365464222,1.1827321112,1.7083908273,-1.182732111
"830","19081","Hancock County","Iowa",120,115,-20,4,5,-16,10.874983008,10.421858716,-1.812497168,0.3624994336,0.453124292,-1.449997734
"831","19083","Hardin County","Iowa",185,225,-48,15,-40,-33,10.697660971,13.010668748,-2.775609333,0.8673779166,-2.313007777,-1.908231416
"832","19085","Harrison County","Iowa",151,188,-86,-2,-37,-88,10.631556713,13.236640146,-6.05505879,-0.140815321,-2.605083433,-6.195874111
"833","19087","Henry County","Iowa",236,213,-28,19,23,-9,11.89636052,10.736969453,-1.411432604,0.9577578385,1.1593910676,-0.453674766
"834","19089","Howard County","Iowa",128,105,-57,-4,23,-61,13.716980121,11.252210256,-6.10834271,-0.428655629,2.4647698655,-6.536998339
"835","19091","Humboldt County","Iowa",110,127,-74,6,-17,-68,11.467292155,13.239510034,-7.714360177,0.625488663,-1.772217879,-7.088871514
"836","19093","Ida County","Iowa",73,76,-8,2,-3,-6,10.480223961,10.910918096,-1.148517694,0.2871294236,-0.430694135,-0.861388271
"837","19095","Iowa County","Iowa",188,168,-52,-4,20,-56,11.536573392,10.309278351,-3.190967108,-0.245459008,1.2272950417,-3.436426117
"838","19097","Jackson County","Iowa",207,241,-30,2,-34,-28,10.67312898,12.426203305,-1.546830287,0.1031220191,-1.753074325,-1.443708268
"839","19099","Jasper County","Iowa",416,385,-171,1,31,-170,11.300969819,10.458830241,-4.645350575,0.0271657928,0.8421395778,-4.618184782
"840","19101","Jefferson County","Iowa",171,128,-152,231,43,79,9.5776856727,7.1692617901,-8.513498376,12.938277137,2.4084238826,4.4247787611
"841","19103","Johnson County","Iowa",1848,690,237,797,1158,1034,12.847787094,4.7970633629,1.6476869812,5.5409557975,8.0507237309,7.1886427787
"842","19105","Jones County","Iowa",211,199,-146,34,12,-112,10.296198702,9.710632899,-7.124383936,1.6591031084,0.585565803,-5.465280828
"843","19107","Keokuk County","Iowa",107,122,-104,5,-15,-99,10.460966906,11.927457594,-10.16766877,0.4888302293,-1.466490688,-9.678838539
"844","19109","Kossuth County","Iowa",180,212,-46,11,-32,-35,11.847561377,13.953794511,-3.02771013,0.7240176397,-2.106233134,-2.30369249
"845","19111","Lee County","Iowa",429,439,-153,-1,-10,-154,12.266079572,12.552002173,-4.374615792,-0.02859226,-0.285922601,-4.403208052
"846","19113","Linn County","Iowa",2891,1775,699,295,1116,994,13.190794277,8.0988100453,3.1893342094,1.345999416,5.0919842313,4.5353336253
"847","19115","Louisa County","Iowa",154,110,-57,37,44,-20,13.668841255,9.7634580393,-5.059246439,3.2840722496,3.9053832157,-1.775174189
"848","19117","Lucas County","Iowa",103,121,-5,-1,-18,-6,11.948955916,14.03712297,-0.580046404,-0.116009281,-2.088167053,-0.696055684
"849","19119","Lyon County","Iowa",162,105,-12,2,57,-10,13.814274751,8.9536965976,-1.023279611,0.1705466019,4.860578153,-0.852733009
"850","19121","Madison County","Iowa",157,138,78,20,19,98,10.017227078,8.8049511899,4.9767115421,1.2760798826,1.2122758885,6.2527914247
"851","19123","Mahaska County","Iowa",297,228,-149,24,69,-125,13.296622121,10.207507891,-6.670695946,1.0744745148,3.0891142301,-5.596221431
"852","19125","Marion County","Iowa",364,353,-178,6,11,-172,10.966993567,10.635573432,-5.362980371,0.1807746192,0.3314201353,-5.182205752
"853","19127","Marshall County","Iowa",516,511,-492,112,5,-380,12.725187734,12.601881651,-12.13331854,2.7620562522,0.1233060827,-9.371262284
"854","19129","Mills County","Iowa",166,128,80,-3,38,77,11.202591443,8.6381427993,5.3988392496,-0.202456472,2.5644486435,5.1963827777
"855","19131","Mitchell County","Iowa",116,136,-6,3,-20,-3,10.854816825,12.726336967,-0.561456043,0.2807280213,-1.871520142,-0.280728021
"856","19133","Monona County","Iowa",94,135,11,1,-41,12,10.581414983,15.196713007,1.2382506895,0.1125682445,-4.615298024,1.350818934
"857","19135","Monroe County","Iowa",84,120,-1,2,-36,1,10.579345088,15.113350126,-0.125944584,0.2518891688,-4.534005038,0.1259445844
"858","19137","Montgomery County","Iowa",127,164,-202,5,-37,-197,12.370330687,15.974285297,-19.67564409,0.4870208932,-3.60395461,-19.18862319
"859","19139","Muscatine County","Iowa",523,399,-188,103,124,-85,12.162507849,9.2788539801,-4.371991349,2.3952931327,2.8836538685,-1.976698216
"860","19141","O'Brien County","Iowa",179,203,-97,6,-24,-91,12.799885588,14.516071365,-6.936250849,0.4290464443,-1.716185777,-6.507204405
"861","19143","Osceola County","Iowa",85,76,-87,10,9,-77,13.716314346,12.263998709,-14.03905115,1.6136840407,1.4523156366,-12.42536711
"862","19145","Page County","Iowa",176,219,16,18,-43,34,11.371712864,14.150029075,1.0337920786,1.1630160884,-2.778316211,2.196808167
"863","19147","Palo Alto County","Iowa",119,143,21,19,-24,40,13.03538175,15.664366305,2.3003614854,2.0812794391,-2.628984555,4.3816409245
"864","19149","Plymouth County","Iowa",301,264,-75,30,37,-45,12.08471344,10.599217103,-3.011141223,1.204456489,1.4854963364,-1.806684734
"865","19151","Pocahontas County","Iowa",85,94,-128,2,-9,-126,12.090178508,13.370315056,-18.20638646,0.2844747884,-1.280136548,-17.92191167
"866","19153","Polk County","Iowa",6969,3520,2064,1053,3449,3117,15.011260061,7.5820972038,4.4458660877,2.2681671465,7.4291628568,6.7140332341
"867","19155","Pottawattamie County","Iowa",1201,911,0,57,290,57,12.853030254,9.7494675785,0,0.6100105949,3.1035626759,0.6100105949
"868","19157","Poweshiek County","Iowa",187,228,20,30,-41,50,10.048361096,12.2514777,1.0746910263,1.6120365395,-2.203116604,2.6867275658
"869","19159","Ringgold County","Iowa",56,86,41,3,-30,44,11.271007346,17.309046996,8.2519875214,0.603803965,-6.03803965,8.8557914864
"870","19161","Sac County","Iowa",111,145,-46,0,-34,-46,11.093898356,14.492029384,-4.597471391,0,-3.398131028,-4.597471391
"871","19163","Scott County","Iowa",2259,1489,-400,258,770,-142,13.162648145,8.6760438638,-2.330703523,1.5033037722,4.4866042815,-0.827399751
"872","19165","Shelby County","Iowa",132,168,-52,-1,-36,-53,11.156186613,14.198782961,-4.394861393,-0.084516565,-3.042596349,-4.479377958
"873","19167","Sioux County","Iowa",508,247,-205,73,261,-132,14.637660279,7.1171300965,-5.906929837,2.1034433079,7.520530183,-3.803486529
"874","19169","Story County","Iowa",895,505,-246,674,390,428,9.3034375942,5.2494256816,-2.557145976,7.0061641771,4.0540119126,4.4490182015
"875","19171","Tama County","Iowa",232,218,-119,12,14,-107,13.43836886,12.627432808,-6.892956441,0.6950880445,0.8109360519,-6.197868397
"876","19173","Taylor County","Iowa",86,75,54,20,11,74,13.839716769,12.069520438,8.6900547152,3.2185387834,1.7701963309,11.908593499
"877","19175","Union County","Iowa",112,150,-168,13,-38,-155,8.9392609147,11.972224439,-13.40889137,1.0375927847,-3.032963525,-12.37129859
"878","19177","Van Buren County","Iowa",77,91,-80,0,-14,-80,10.484749455,12.391067538,-10.89324619,0,-1.906318083,-10.89324619
"879","19179","Wapello County","Iowa",438,444,-64,149,-6,85,12.349333897,12.518502855,-1.80446888,4.2010291112,-0.169168957,2.3965602312
"880","19181","Warren County","Iowa",536,387,485,3,149,488,11.132688773,8.0379674535,10.073421744,0.0623098252,3.0947213193,10.135731569
"881","19183","Washington County","Iowa",323,254,41,9,69,50,14.622331877,11.498675841,1.8560854705,0.407433396,3.1236560357,2.2635188664
"882","19185","Wayne County","Iowa",82,87,-12,-1,-5,-13,12.878906864,13.664206063,-1.884718078,-0.15705984,-0.785299199,-2.041777917
"883","19187","Webster County","Iowa",451,454,-63,46,-3,-17,12.169783318,12.250735314,-1.699991905,1.2412639305,-0.080951995,-0.458727974
"884","19189","Winnebago County","Iowa",119,139,58,5,-20,63,11.252423053,13.143586592,5.4843742613,0.4727908846,-1.891163538,5.9571651459
"885","19191","Winneshiek County","Iowa",176,187,53,3,-11,56,8.4962587497,9.0272749216,2.5585324644,0.1448225923,-0.531016172,2.7033550567
"886","19193","Woodbury County","Iowa",1548,995,-512,146,553,-366,15.1171875,9.716796875,-5,1.42578125,5.400390625,-3.57421875
"887","19195","Worth County","Iowa",71,84,-41,1,-13,-40,9.4295769971,11.156119264,-5.445248688,0.1328109436,-1.726542267,-5.312437745
"888","19197","Wright County","Iowa",157,162,-76,18,-5,-58,12.195121951,12.583501631,-5.903371136,1.3981668479,-0.38837968,-4.505204288
"889","20001","Allen County","Kansas",135,183,-184,4,-48,-180,10.566687539,14.323731997,-14.40200376,0.3130870382,-3.757044458,-14.08891672
"890","20003","Anderson County","Kansas",88,85,-65,-2,3,-67,11.211619315,10.82940502,-8.281309721,-0.25480953,0.3822142948,-8.536119251
"891","20005","Atchison County","Kansas",199,190,-114,1,9,-113,12.081474061,11.535075737,-6.921045442,0.0607109249,0.5463983244,-6.860334517
"892","20007","Barber County","Kansas",54,70,-44,0,-16,-44,11.127137853,14.424067587,-9.066556769,0,-3.296929734,-9.066556769
"893","20009","Barton County","Kansas",334,305,-215,14,29,-201,12.252833926,11.188965112,-7.887303276,0.5135918412,1.063868814,-7.373711435
"894","20011","Bourbon County","Kansas",210,201,-96,32,9,-64,14.218009479,13.608666215,-6.499661476,2.1665538253,0.6093432634,-4.333107651
"895","20013","Brown County","Kansas",116,116,-80,-2,0,-82,11.910262334,11.910262334,-8.213974023,-0.205349351,0,-8.419323374
"896","20015","Butler County","Kansas",755,619,221,26,136,247,11.429696016,9.3708368657,3.3456461184,0.3936054257,2.0588591498,3.7392515441
"897","20017","Chase County","Kansas",30,33,4,0,-3,4,11.30369254,12.434061794,1.5071590053,0,-1.130369254,1.5071590053
"898","20019","Chautauqua County","Kansas",38,53,-55,0,-15,-55,11.109486917,15.4948107,-16.07952054,0,-4.385323783,-16.07952054
"899","20021","Cherokee County","Kansas",237,268,-207,-3,-31,-210,11.478943162,12.980408302,-10.02591238,-0.145303078,-1.501465139,-10.17121546
"900","20023","Cheyenne County","Kansas",42,40,-18,6,2,-12,15.662875256,14.917024054,-6.712660824,2.2375536081,0.7458512027,-4.475107216
"901","20025","Clark County","Kansas",21,40,-13,0,-19,-13,10.011918951,19.070321812,-6.197854589,0,-9.058402861,-6.197854589
"902","20027","Clay County","Kansas",108,103,-11,-1,5,-12,13.015184382,12.412629549,-1.325620631,-0.120510966,0.6025548325,-1.446131598
"903","20029","Cloud County","Kansas",111,160,-107,23,-49,-84,11.979279085,17.267429311,-11.54759335,2.4821929635,-5.288150227,-9.065400389
"904","20031","Coffey County","Kansas",77,101,-82,1,-24,-81,9.2298471681,12.106682649,-9.829187893,0.119868145,-2.876835481,-9.709319748
"905","20033","Comanche County","Kansas",21,38,-107,0,-17,-107,11.119936458,20.12178978,-56.65872385,0,-9.001853323,-56.65872385
"906","20035","Cowley County","Kansas",458,449,-213,89,9,-124,12.78222768,12.531048533,-5.944573135,2.4838826714,0.2511791465,-3.460690464
"907","20037","Crawford County","Kansas",517,441,-369,178,76,-191,13.186420792,11.24799143,-9.411584666,4.5400056112,1.9384293621,-4.871579055
"908","20039","Decatur County","Kansas",35,38,26,6,-3,32,12.021294865,13.051691568,8.930104757,2.0607934055,-1.030396703,10.990898162
"909","20041","Dickinson County","Kansas",237,241,-99,5,-4,-94,12.30945023,12.517204664,-5.141922248,0.2596930428,-0.207754434,-4.882229205
"910","20043","Doniphan County","Kansas",82,82,-59,3,0,-56,10.49734366,10.49734366,-7.55296678,0.3840491583,0,-7.168917621
"911","20045","Douglas County","Kansas",1258,677,284,921,581,1205,10.721438616,5.7698044062,2.4204201645,7.8493203222,4.9516342097,10.269740487
"912","20047","Edwards County","Kansas",34,36,-70,2,-2,-68,11.369336231,12.038120716,-23.40745695,0.6687844842,-0.668784484,-22.73867246
"913","20049","Elk County","Kansas",22,51,-96,0,-29,-96,8.3523158694,19.362186788,-36.44646925,0,-11.00987092,-36.44646925
"914","20051","Ellis County","Kansas",357,242,-172,98,115,-74,12.317777969,8.3498662986,-5.934615716,3.3813508151,3.9679116708,-2.553264901
"915","20053","Ellsworth County","Kansas",65,102,-5,0,-37,-5,10.271807838,16.118836915,-0.790139064,0,-5.847029077,-0.790139064
"916","20055","Finney County","Kansas",732,207,-683,213,525,-470,19.689063425,5.5678089193,-18.37107967,5.729194685,14.121254505,-12.64188499
"917","20057","Ford County","Kansas",660,227,-1075,362,433,-713,18.951630271,6.5182122295,-30.86818567,10.394682058,12.433418041,-20.47350361
"918","20059","Franklin County","Kansas",330,250,-163,26,80,-137,12.941937761,9.8044983038,-6.392532894,1.0196678236,3.1374394572,-5.37286507
"919","20061","Geary County","Kansas",1091,200,-927,240,891,-687,29.84503016,5.4711329349,-25.35870115,6.5653595218,24.373897225,-18.79334163
"920","20063","Gove County","Kansas",44,41,-56,3,3,-53,16.158648549,15.056922512,-20.5655527,1.1017260375,1.1017260375,-19.46382666
"921","20065","Graham County","Kansas",26,39,41,10,-13,51,10.089251067,15.133876601,15.909972837,3.8804811797,-5.044625534,19.790454016
"922","20067","Grant County","Kansas",131,58,-137,0,73,-137,16.864057673,7.4665293512,-17.63645726,0,9.3975283213,-17.63645726
"923","20069","Gray County","Kansas",83,48,-39,20,35,-19,13.676058659,7.9090459713,-6.426099852,3.2954358214,5.7670126874,-3.13066403
"924","20071","Greeley County","Kansas",16,25,6,4,-9,10,12.298232129,19.215987702,4.6118370484,3.0745580323,-6.917755573,7.6863950807
"925","20073","Greenwood County","Kansas",68,92,-30,0,-24,-30,10.861752256,14.695311876,-4.791949525,0,-3.83355962,-4.791949525
"926","20075","Hamilton County","Kansas",41,26,-127,17,15,-110,15.696784074,9.954058193,-48.62174579,6.5084226646,5.7427258806,-42.11332312
"927","20077","Harper County","Kansas",78,92,-39,6,-14,-33,13.439007581,15.851137147,-6.71950379,1.0337698139,-2.412129566,-5.685733977
"928","20079","Harvey County","Kansas",424,410,140,60,14,200,12.216555738,11.813178898,4.0337684041,1.7287578875,0.4033768404,5.7625262915
"929","20081","Haskell County","Kansas",52,36,-28,1,16,-27,12.703065836,8.7944301942,-6.840112373,0.2442897276,3.9086356419,-6.595822646
"930","20083","Hodgeman County","Kansas",24,25,-28,6,-1,-22,12.823938018,13.358268768,-14.96126102,3.2059845044,-0.534330751,-11.75527652
"931","20085","Jackson County","Kansas",171,143,-184,0,28,-184,12.798922196,10.703192246,-13.77193967,0,2.0957299502,-13.77193967
"932","20087","Jefferson County","Kansas",160,187,22,-1,-27,21,8.5027235286,9.9375581241,1.1691244852,-0.053142022,-1.434834595,1.1159824631
"933","20089","Jewell County","Kansas",22,44,-59,0,-22,-59,7.3272273106,14.654454621,-19.65029142,0,-7.327227311,-19.65029142
"934","20091","Johnson County","Kansas",7508,3887,1145,1969,3621,3114,13.026230296,6.7438674961,1.9865521695,3.4161757396,6.2823627999,5.4027279091
"935","20093","Kearny County","Kansas",56,34,-37,12,22,-25,14.222222222,8.6349206349,-9.396825397,3.0476190476,5.5873015873,-6.349206349
"936","20095","Kingman County","Kansas",92,124,-13,-3,-32,-16,12.012796239,16.191160149,-1.697460338,-0.391721617,-4.178363909,-2.089181955
"937","20097","Kiowa County","Kansas",35,22,21,5,13,26,13.714733542,8.6206896552,8.2288401254,1.9592476489,5.0940438871,10.188087774
"938","20099","Labette County","Kansas",267,260,-154,4,7,-150,12.897304608,12.559173027,-7.438894793,0.1932180466,0.3381315815,-7.245676746
"939","20101","Lane County","Kansas",18,28,-25,0,-10,-25,10.922330097,16.990291262,-15.16990291,0,-6.067961165,-15.16990291
"940","20103","Leavenworth County","Kansas",1008,594,-71,227,414,156,12.788956837,7.5363495648,-0.90080946,2.8800527798,5.2526072725,1.9792433201
"941","20105","Lincoln County","Kansas",36,34,-47,3,2,-44,11.379800853,10.747589695,-14.85696223,0.9483167378,0.6322111585,-13.90864549
"942","20107","Linn County","Kansas",98,101,46,1,-3,47,10.251582196,10.56540614,4.8119671531,0.1046079816,-0.313823945,4.9165751347
"943","20109","Logan County","Kansas",37,43,23,1,-6,24,13.323730645,15.484335614,8.2823190493,0.3601008282,-2.160604969,8.6424198776
"944","20111","Lyon County","Kansas",401,285,-249,145,116,-104,12.093065336,8.5948219967,-7.509160271,4.3728041738,3.498243339,-3.136356097
"945","20113","McPherson County","Kansas",345,370,-239,4,-25,-235,11.994367862,12.863524954,-8.309141794,0.1390651346,-0.869157091,-8.17007666
"946","20115","Marion County","Kansas",115,191,-69,8,-76,-61,9.49158138,15.76427864,-5.694948828,0.6602839221,-6.27269726,-5.034664906
"947","20117","Marshall County","Kansas",120,128,-96,3,-8,-93,12.13040182,12.939095274,-9.704321456,0.3032600455,-0.808693455,-9.40106141
"948","20119","Meade County","Kansas",64,45,-85,9,19,-76,14.778893892,10.391409768,-19.62821845,2.0782819536,4.3874841242,-17.5499365
"949","20121","Miami County","Kansas",347,334,-144,19,13,-125,10.575399244,10.179202731,-4.388638303,0.5790564428,0.3961965135,-3.80958186
"950","20123","Mitchell County","Kansas",93,73,15,18,20,33,14.825442372,11.637175195,2.3912003826,2.8694404591,3.1882671768,5.2606408417
"951","20125","Montgomery County","Kansas",448,441,-756,71,7,-685,13.269945647,13.062602746,-22.39303328,2.1030494217,0.2073429007,-20.28998386
"952","20127","Morris County","Kansas",66,87,-23,9,-21,-14,11.689691817,15.409139214,-4.073680482,1.5940488842,-3.719447396,-2.479631598
"953","20129","Morton County","Kansas",27,46,-73,2,-19,-71,9.0120160214,15.353805073,-24.36582109,0.6675567423,-6.341789052,-23.69826435
"954","20131","Nemaha County","Kansas",148,131,-17,7,17,-10,14.667988107,12.983151635,-1.684836472,0.6937561943,1.6848364718,-0.991080278
"955","20133","Neosho County","Kansas",209,204,-82,15,5,-67,12.828382028,12.521482936,-5.033145102,0.9206972747,0.3068990916,-4.112447827
"956","20135","Ness County","Kansas",36,50,-65,5,-14,-60,11.795543906,16.382699869,-21.29750983,1.6382699869,-4.587155963,-19.65923984
"957","20137","Norton County","Kansas",52,69,20,2,-17,22,9.3930635838,12.463872832,3.612716763,0.3612716763,-3.070809249,3.9739884393
"958","20139","Osage County","Kansas",158,215,-52,4,-57,-48,9.9271173662,13.508419201,-3.267152551,0.251319427,-3.581301835,-3.015833124
"959","20141","Osborne County","Kansas",39,75,-79,5,-36,-74,10.54909386,20.286718961,-21.36867731,1.3524479308,-9.737625101,-20.01622938
"960","20143","Ottawa County","Kansas",63,71,-90,4,-8,-86,10.529834531,11.866956376,-15.04262076,0.6685609226,-1.337121845,-14.37405984
"961","20145","Pawnee County","Kansas",68,83,-34,-4,-15,-38,10.007358352,12.21486387,-5.003679176,-0.588668138,-2.207505519,-5.592347314
"962","20147","Phillips County","Kansas",63,65,-77,3,-2,-74,11.541632317,11.908033342,-14.1064395,0.5496015389,-0.366401026,-13.55683796
"963","20149","Pottawatomie County","Kansas",344,186,209,21,158,230,15.000872144,8.1109366824,9.113901971,0.9157509158,6.8899354614,10.029652887
"964","20151","Pratt County","Kansas",143,110,-113,9,33,-104,14.694548631,11.303498947,-11.61177619,0.924831732,3.391049684,-10.68694446
"965","20153","Rawlins County","Kansas",35,39,-35,5,-4,-30,13.858641853,15.442486636,-13.85864185,1.979805979,-1.583844783,-11.87883587
"966","20155","Reno County","Kansas",709,743,-143,74,-34,-69,11.139916726,11.67412994,-2.246837929,1.1626993479,-0.534213214,-1.084138581
"967","20157","Republic County","Kansas",48,95,-14,7,-47,-7,10.181355393,20.150599215,-2.96956199,1.4847809948,-9.969243822,-1.484780995
"968","20159","Rice County","Kansas",133,114,-79,16,19,-63,13.371537727,11.461318052,-7.942492334,1.6086060423,1.9102196753,-6.333886292
"969","20161","Riley County","Kansas",1011,354,-1127,1119,657,-8,13.161149225,4.6083549214,-14.67123163,14.567088014,8.5527943033,-0.104143614
"970","20163","Rooks County","Kansas",47,67,-6,5,-20,-1,9.0506450992,12.901983439,-1.155401502,0.962834585,-3.85133834,-0.192566917
"971","20165","Rush County","Kansas",30,44,-48,0,-14,-48,9.5816033216,14.053018205,-15.33056531,0,-4.471414883,-15.33056531
"972","20167","Russell County","Kansas",92,89,41,-6,3,35,13.101680433,12.674451723,5.8387923668,-0.85445742,0.4272287098,4.9843349473
"973","20169","Saline County","Kansas",766,529,-333,27,237,-306,13.804662227,9.5335069429,-6.001243501,0.4865873109,4.2711552844,-5.51465619
"974","20171","Scott County","Kansas",64,35,-46,1,29,-45,12.901925209,7.0557403488,-9.273258744,0.2015925814,5.8461848604,-9.071666163
"975","20173","Sedgwick County","Kansas",7258,4490,-2131,1488,2768,-643,14.228080562,8.801885054,-4.177464822,2.9169721515,5.4261955077,-1.26049267
"976","20175","Seward County","Kansas",442,133,-557,178,309,-379,18.967921897,5.7075421092,-23.9030147,7.6386653793,13.260379788,-16.26434932
"977","20177","Shawnee County","Kansas",2271,1925,-526,346,346,-180,12.71122405,10.774595463,-2.944123228,1.9366285871,1.9366285871,-1.007494641
"978","20179","Sheridan County","Kansas",27,31,-26,4,-4,-22,10.847730012,12.454801125,-10.44596223,1.6070711129,-1.607071113,-8.838891121
"979","20181","Sherman County","Kansas",75,68,-112,-1,7,-113,12.46882793,11.305070657,-18.62011638,-0.166251039,1.1637572735,-18.78636741
"980","20183","Smith County","Kansas",39,66,-14,0,-27,-14,10.514963602,17.794553788,-3.774602319,0,-7.279590186,-3.774602319
"981","20185","Stafford County","Kansas",48,64,-50,0,-16,-50,11.296775712,15.062367616,-11.7674747,0,-3.765591904,-11.7674747
"982","20187","Stanton County","Kansas",27,18,-83,3,9,-80,12.83269962,8.5551330798,-39.4486692,1.4258555133,4.2775665399,-38.02281369
"983","20189","Stevens County","Kansas",80,54,-106,30,26,-76,13.749248088,9.2807424594,-18.21775372,5.155968033,4.4685056286,-13.06178568
"984","20191","Sumner County","Kansas",277,246,-15,10,31,-5,11.842161515,10.516865461,-0.641272284,0.4275148561,1.325296054,-0.213757428
"985","20193","Thomas County","Kansas",127,78,-2,13,49,11,16.145436054,9.9160945843,-0.254258835,1.6526824307,6.2293414696,1.3984235952
"986","20195","Trego County","Kansas",45,45,11,0,0,11,15.514566454,15.514566454,3.7924495777,0,0,3.7924495777
"987","20197","Wabaunsee County","Kansas",90,74,-76,4,16,-72,13.022717407,10.707567646,-10.99696137,0.5787874403,2.3151497613,-10.41817393
"988","20199","Wallace County","Kansas",20,21,3,1,-1,4,13.306719894,13.972055888,1.996007984,0.6653359947,-0.665335995,2.6613439787
"989","20201","Washington County","Kansas",75,72,-47,3,3,-44,13.419216318,12.882447665,-8.409375559,0.5367686527,0.5367686527,-7.872606906
"990","20203","Wichita County","Kansas",21,23,-22,2,-2,-20,9.657392504,10.577144171,-10.11726834,0.919751667,-0.919751667,-9.19751667
"991","20205","Wilson County","Kansas",91,117,-99,0,-26,-99,10.212670445,13.130576286,-11.11048763,0,-2.917905841,-11.11048763
"992","20207","Woodson County","Kansas",30,54,-19,0,-24,-19,9.4756790903,17.056222363,-6.001263424,0,-7.580543272,-6.001263424
"993","20209","Wyandotte County","Kansas",2723,1369,-761,939,1354,178,16.697736025,8.3948588388,-4.666535848,5.7580514607,8.3028771861,1.0915156124
"994","21001","Adair County","Kentucky",205,195,-118,8,10,-110,10.667915593,10.147529467,-6.140556293,0.4163089012,0.5203861265,-5.724247392
"995","21003","Allen County","Kentucky",244,248,169,2,-4,171,11.8481111,12.04234243,8.2062736719,0.0971156648,-0.19423133,8.3033893367
"996","21005","Anderson County","Kentucky",251,215,0,3,36,3,11.475859546,9.8299195318,0,0.1371616679,1.6459400146,0.1371616679
"997","21007","Ballard County","Kentucky",86,116,56,1,-30,57,10.484608351,14.142029869,6.8271868333,0.1219140506,-3.657421518,6.9491008839
"998","21009","Barren County","Kentucky",553,512,446,30,41,476,12.769298266,11.8225691,10.298566052,0.6927286582,0.9467291662,10.99129471
"999","21011","Bath County","Kentucky",161,140,47,3,21,50,13.233601841,11.507479862,3.8632253822,0.2465888542,1.7261219793,4.1098142364
"1000","21013","Bell County","Kentucky",339,397,-408,9,-58,-399,12.274159093,14.374162714,-14.77243926,0.3258626308,-2.100003621,-14.44657663
"1001","21015","Boone County","Kentucky",1743,844,411,194,899,605,13.716417206,6.6417992666,3.2343358988,1.5266694997,7.0746179392,4.7610053984
"1002","21017","Bourbon County","Kentucky",228,218,95,7,10,102,11.327503975,10.830683625,4.7197933227,0.3477742448,0.4968203498,5.0675675676
"1003","21019","Boyd County","Kentucky",641,627,-346,-1,14,-347,13.169519035,12.881885234,-7.108663941,-0.020545272,0.2876338011,-7.129209212
"1004","21021","Boyle County","Kentucky",324,335,-49,16,-11,-33,10.8775935,11.246894514,-1.645068153,0.5371651111,-0.369301014,-1.107903042
"1005","21023","Bracken County","Kentucky",108,112,-68,4,-4,-64,12.976869931,13.457494743,-8.170621808,0.4806248123,-0.480624812,-7.689996996
"1006","21025","Breathitt County","Kentucky",181,187,7,0,-6,7,13.537771129,13.986537023,0.5235602094,0,-0.448765894,0.5235602094
"1007","21027","Breckinridge County","Kentucky",224,241,114,6,-17,120,11.235391483,12.088077444,5.718011737,0.3009479862,-0.852685961,6.0189597231
"1008","21029","Bullitt County","Kentucky",785,571,442,-6,214,436,10.01607676,7.2855794013,5.639625386,-0.076556001,2.7304973588,5.5630693853
"1009","21031","Butler County","Kentucky",155,140,-18,1,15,-17,12.171181782,10.993325481,-1.413427562,0.0785237534,1.1778563015,-1.334903808
"1010","21033","Caldwell County","Kentucky",134,196,-35,-1,-62,-36,10.467114513,15.310107796,-2.733947821,-0.078112795,-4.842993282,-2.812060616
"1011","21035","Calloway County","Kentucky",395,421,32,192,-26,224,10.243377462,10.917625092,0.8298432374,4.9790594246,-0.67424763,5.808902662
"1012","21037","Campbell County","Kentucky",1112,848,-85,141,264,56,12.114477454,9.2383784903,-0.926016712,1.5360983103,2.876098964,0.6100815984
"1013","21039","Carlisle County","Kentucky",67,64,-112,2,3,-110,13.647010897,13.035950708,-22.81291374,0.4073734596,0.6110601894,-22.40554028
"1014","21041","Carroll County","Kentucky",171,154,-71,0,17,-71,15.940340247,14.355628059,-6.618503845,0,1.5847121883,-6.618503845
"1015","21043","Carter County","Kentucky",378,343,-120,7,35,-113,13.754457463,12.480896587,-4.366494433,0.2547121752,1.2735608762,-4.111782257
"1016","21045","Casey County","Kentucky",195,194,-31,-4,1,-35,12.369564528,12.306130864,-1.966443592,-0.253734657,0.0634336642,-2.220178249
"1017","21047","Christian County","Kentucky",1669,584,-1704,386,1085,-1318,22.77969618,7.9708463565,-23.25740101,5.2684018726,14.808849823,-17.98899914
"1018","21049","Clark County","Kentucky",451,428,14,12,23,26,12.649706897,12.004599893,0.3926738283,0.3365775671,0.6451070036,0.7292513954
"1019","21051","Clay County","Kentucky",280,234,-160,10,46,-150,13.306719894,11.120615911,-7.603839939,0.4752399962,2.1861039825,-7.128599943
"1020","21053","Clinton County","Kentucky",137,170,0,10,-33,10,13.430055877,16.66503284,0,0.9802960494,-3.234976963,0.9802960494
"1021","21055","Crittenden County","Kentucky",114,138,21,-1,-24,20,12.42845462,15.044971382,2.2894521668,-0.109021532,-2.616516762,2.1804306351
"1022","21057","Cumberland County","Kentucky",79,119,56,1,-40,57,11.729769859,17.668893838,8.3147735709,0.1484780995,-5.939123979,8.4632516704
"1023","21059","Daviess County","Kentucky",1356,1060,535,200,296,735,13.697384769,10.707395174,5.4042041678,2.0202632403,2.9899895956,7.4244674081
"1024","21061","Edmonson County","Kentucky",110,148,25,1,-38,26,9.1647573422,12.330764424,2.082899396,0.0833159758,-3.166007082,2.1662153718
"1025","21063","Elliott County","Kentucky",80,70,5,1,10,6,10.609376036,9.2832040316,0.6630860023,0.1326172005,1.3261720045,0.7957032027
"1026","21065","Estill County","Kentucky",161,198,-30,0,-37,-30,11.172021373,13.739504545,-2.081743113,0,-2.567483173,-2.081743113
"1027","21067","Fayette County","Kentucky",3965,2347,1006,1419,1618,2425,12.628253208,7.4750341186,3.204041041,4.5194177308,5.1532190898,7.7234587719
"1028","21069","Fleming County","Kentucky",193,184,94,0,9,94,13.28469163,12.665198238,6.4702643172,0,0.6194933921,6.4702643172
"1029","21071","Floyd County","Kentucky",460,509,-439,10,-49,-429,12.17817195,13.475412006,-11.62221193,0.2647428685,-1.297240056,-11.35746906
"1030","21073","Franklin County","Kentucky",587,535,226,73,52,299,11.758107486,10.716503415,4.5269715362,1.4622518679,1.0416040703,5.989223404
"1031","21075","Fulton County","Kentucky",78,84,5,2,-6,7,12.444160817,13.401403957,0.7977026165,0.3190810466,-0.95724314,1.1167836631
"1032","21077","Gallatin County","Kentucky",104,100,-36,8,4,-28,12.074069774,11.609682475,-4.179485691,0.928774598,0.464387299,-3.250711093
"1033","21079","Garrard County","Kentucky",190,171,211,1,19,212,11.113060771,10.001754694,12.341346435,0.0584897935,1.1113060771,12.399836229
"1034","21081","Grant County","Kentucky",362,233,-211,-4,129,-215,14.61415797,9.4063502957,-8.518197049,-0.161482409,5.2078076745,-8.679679457
"1035","21083","Graves County","Kentucky",463,437,-418,43,26,-375,12.378851681,11.683710982,-11.17572355,1.1496557717,0.6951406992,-10.02606778
"1036","21085","Grayson County","Kentucky",351,309,21,8,42,29,13.443640124,11.834999425,0.8043203493,0.3064077521,1.6086406986,1.1107281014
"1037","21087","Green County","Kentucky",118,152,-30,0,-34,-30,10.721911771,13.81127618,-2.725909772,0,-3.089364409,-2.725909772
"1038","21089","Greenup County","Kentucky",383,481,-197,0,-98,-197,10.600168828,13.312483567,-5.452306159,0,-2.712314739,-5.452306159
"1039","21091","Hancock County","Kentucky",124,75,-89,-2,49,-91,14.311270125,8.6560101564,-10.27179872,-0.230826938,5.6552599688,-10.50262566
"1040","21093","Hardin County","Kentucky",1520,934,-3151,304,586,-2847,14.149143139,8.6942761131,-29.33154607,2.8298286278,5.454867026,-26.50171745
"1041","21095","Harlan County","Kentucky",339,391,-462,5,-52,-457,12.209836302,14.082731546,-16.6399539,0.1800860811,-1.872895244,-16.45986782
"1042","21097","Harrison County","Kentucky",206,220,23,0,-14,23,11.055357287,11.806692248,1.2343360077,0,-0.751334961,1.2343360077
"1043","21099","Hart County","Kentucky",259,234,-125,8,25,-117,14.026916515,12.672967045,-6.769747353,0.4332638306,1.3539494706,-6.336483522
"1044","21101","Henderson County","Kentucky",573,524,-58,5,49,-53,12.348339547,11.292373338,-1.249919186,0.107751654,1.0559662091,-1.142167532
"1045","21103","Henry County","Kentucky",172,164,7,3,8,10,11.051143665,10.537136983,0.4497558468,0.1927525058,0.5140066821,0.6425083526
"1046","21105","Hickman County","Kentucky",44,74,-39,0,-30,-39,9.4745908699,15.93453919,-8.397932817,0,-6.45994832,-8.397932817
"1047","21107","Hopkins County","Kentucky",584,638,-73,32,-54,-41,12.660697639,13.831378585,-1.582587205,0.6937368569,-1.170680946,-0.888850348
"1048","21109","Jackson County","Kentucky",175,161,7,0,14,7,13.140111128,12.088902238,0.5256044451,0,1.0512088902,0.5256044451
"1049","21111","Jefferson County","Kentucky",10051,7720,-1603,2606,2331,1003,13.162952268,10.110236942,-2.099314743,3.4128597761,3.0527153255,1.3135450328
"1050","21113","Jessamine County","Kentucky",647,477,635,112,170,747,12.598701185,9.2883778442,12.365031302,2.1809189068,3.3103233407,14.545950209
"1051","21115","Johnson County","Kentucky",275,286,-110,-1,-11,-111,11.854725725,12.328914754,-4.74189029,-0.043108094,-0.474189029,-4.784998383
"1052","21117","Kenton County","Kentucky",2356,1509,-63,118,847,55,14.396490092,9.2208419136,-0.384965567,0.7210466175,5.1756481781,0.3360810505
"1053","21119","Knott County","Kentucky",162,195,-236,4,-33,-232,10.237937245,12.32344298,-14.91452586,0.252788574,-2.085505735,-14.66173729
"1054","21121","Knox County","Kentucky",388,388,-107,38,0,-69,12.309058896,12.309058896,-3.39450851,1.2055263868,0,-2.188982123
"1055","21123","Larue County","Kentucky",149,167,25,-1,-18,24,10.553155323,11.828033147,1.7706636447,-0.070826546,-1.274877824,1.6998370989
"1056","21125","Laurel County","Kentucky",762,603,-128,-5,159,-133,12.716849826,10.063333917,-2.13616375,-0.083443896,2.6535159086,-2.219607647
"1057","21127","Lawrence County","Kentucky",213,227,-27,24,-14,-3,13.410986935,14.292460255,-1.699984259,1.5110971195,-0.88147332,-0.18888714
"1058","21129","Lee County","Kentucky",63,91,-25,0,-28,-25,9.3071354705,13.443640124,-3.693307726,0,-4.136504654,-3.693307726
"1059","21131","Leslie County","Kentucky",146,159,-174,-1,-13,-175,13.595306826,14.805847844,-16.20262594,-0.09311854,-1.210541019,-16.29574448
"1060","21133","Letcher County","Kentucky",256,282,-290,0,-26,-290,11.033769368,12.15438657,-12.49919186,0,-1.120617201,-12.49919186
"1061","21135","Lewis County","Kentucky",157,175,-146,0,-18,-146,11.475349925,12.790995139,-10.67134452,0,-1.315645214,-10.67134452
"1062","21137","Lincoln County","Kentucky",324,321,-87,0,3,-87,13.286311818,13.163290413,-3.567620766,0,0.1230214057,-3.567620766
"1063","21139","Livingston County","Kentucky",94,114,-21,0,-20,-21,10.100467415,12.249503036,-2.256487401,0,-2.14903562,-2.256487401
"1064","21141","Logan County","Kentucky",331,342,-50,-8,-11,-58,12.35674021,12.767387165,-1.866577071,-0.298652331,-0.410646956,-2.165229402
"1065","21143","Lyon County","Kentucky",45,135,-8,-1,-90,-9,5.3814876824,16.144463047,-0.956708921,-0.119588615,-10.76297536,-1.076297536
"1066","21145","McCracken County","Kentucky",755,817,-323,21,-62,-302,11.585351819,12.536731703,-4.956382301,0.3222415738,-0.951379884,-4.634140727
"1067","21147","McCreary County","Kentucky",202,238,-9,4,-36,-5,11.284600989,13.295717997,-0.502779252,0.2234574453,-2.011117008,-0.279321807
"1068","21149","McLean County","Kentucky",87,126,31,1,-39,32,9.239101577,13.380767801,3.2920936654,0.1061965699,-4.141666224,3.3982902352
"1069","21151","Madison County","Kentucky",989,761,760,144,228,904,11.281068565,8.6803773284,8.6689707878,1.6425418335,2.6006912364,10.311512621
"1070","21153","Magoffin County","Kentucky",140,173,-172,3,-33,-169,10.868299499,13.430112953,-13.35248224,0.2328921321,-2.561813453,-13.11959011
"1071","21155","Marion County","Kentucky",271,201,62,16,70,78,14.156241022,10.4996474,3.2386972079,0.8357928279,3.6565936219,4.0744900358
"1072","21157","Marshall County","Kentucky",345,428,146,6,-83,152,11.1189893,13.793992523,4.7054273559,0.193373727,-2.675003223,4.8988010829
"1073","21159","Martin County","Kentucky",118,119,-211,-1,-1,-212,9.5092271738,9.5898138448,-17.00378757,-0.080586671,-0.080586671,-17.08437424
"1074","21161","Mason County","Kentucky",182,242,-39,23,-60,-16,10.640474729,14.148323541,-2.280101728,1.3446753778,-3.507848812,-0.93542635
"1075","21163","Meade County","Kentucky",291,249,-1468,42,42,-1426,10.239808575,8.7618980594,-51.65649137,1.477910516,1.477910516,-50.17858085
"1076","21165","Menifee County","Kentucky",78,88,77,0,-10,77,12.317410186,13.896565338,12.15949467,0,-1.579155152,12.15949467
"1077","21167","Mercer County","Kentucky",247,294,57,22,-47,79,11.548531887,13.746025809,2.6650458201,1.0286141762,-2.197493922,3.6936599963
"1078","21169","Metcalfe County","Kentucky",136,135,-76,0,1,-76,13.666281465,13.565794101,-7.637039642,0,0.1004873637,-7.637039642
"1079","21171","Monroe County","Kentucky",139,151,-46,1,-12,-45,13.051030468,14.177738134,-4.319046054,0.0938923055,-1.126707666,-4.225153749
"1080","21173","Montgomery County","Kentucky",374,312,155,0,62,155,13.610393391,11.354124968,5.6406710579,0,2.2562684232,5.6406710579
"1081","21175","Morgan County","Kentucky",141,172,-54,4,-31,-50,10.594334661,12.923585544,-4.057404764,0.300548501,-2.329250883,-3.756856263
"1082","21177","Muhlenberg County","Kentucky",362,418,5,-3,-56,2,11.573445018,13.363812203,0.159854213,-0.095912528,-1.790367185,0.0639416852
"1083","21179","Nelson County","Kentucky",557,376,76,-2,181,74,12.380391416,8.3573198786,1.6892455074,-0.044453829,4.0230715373,1.6447916782
"1084","21181","Nicholas County","Kentucky",89,100,21,1,-11,22,12.613378685,14.172335601,2.9761904762,0.141723356,-1.558956916,3.1179138322
"1085","21183","Ohio County","Kentucky",272,285,91,-8,-13,83,11.337584928,11.879454796,3.7930890751,-0.33345838,-0.541869868,3.4596306948
"1086","21185","Oldham County","Kentucky",546,413,427,17,133,444,8.4965998039,6.4269152363,6.6447767697,0.2645461477,2.0696845676,6.9093229175
"1087","21187","Owen County","Kentucky",87,116,107,0,-29,107,8.1392085321,10.852278043,10.010290953,0,-2.713069511,10.010290953
"1088","21189","Owsley County","Kentucky",52,72,-37,0,-20,-37,11.617515639,16.085790885,-8.266309205,0,-4.468275246,-8.266309205
"1089","21191","Pendleton County","Kentucky",176,173,-2,3,3,1,12.162675789,11.955357451,-0.138212225,0.2073183373,0.2073183373,0.0691061124
"1090","21193","Perry County","Kentucky",414,411,-215,2,3,-213,15.084440072,14.975132535,-7.833706801,0.0728716912,0.1093075368,-7.76083511
"1091","21195","Pike County","Kentucky",705,833,-1058,12,-128,-1046,11.304508174,13.356957885,-16.96477964,0.1924171604,-2.052449711,-16.77236248
"1092","21197","Powell County","Kentucky",170,190,-110,0,-20,-110,13.83013342,15.45720794,-8.94890986,0,-1.62707452,-8.94890986
"1093","21199","Pulaski County","Kentucky",731,815,46,43,-84,89,11.446915127,12.762292515,0.7203257125,0.6733479486,-1.315377388,1.3936736611
"1094","21201","Robertson County","Kentucky",19,40,-33,0,-21,-33,8.7922258214,18.509949098,-15.27070801,0,-9.717723276,-15.27070801
"1095","21203","Rockcastle County","Kentucky",167,189,128,1,-22,129,9.8933649289,11.196682464,7.5829383886,0.0592417062,-1.303317536,7.6421800948
"1096","21205","Rowan County","Kentucky",273,223,315,28,50,343,11.162448379,9.1180439138,12.879748129,1.1448665004,2.044404465,14.02461463
"1097","21207","Russell County","Kentucky",222,234,-97,6,-12,-91,12.516209055,13.192760895,-5.468794046,0.3382759204,-0.676551841,-5.130518126
"1098","21209","Scott County","Kentucky",687,393,575,37,294,612,13.293215042,7.604415592,11.126053347,0.7159373458,5.6887994505,11.841990693
"1099","21211","Shelby County","Kentucky",619,366,328,144,253,472,13.581113695,8.0301900039,7.1964544298,3.1594190179,5.5509236913,10.355873448
"1100","21213","Simpson County","Kentucky",236,203,85,24,33,109,13.230924483,11.380837585,4.7653753434,1.345517744,1.850086898,6.1108930874
"1101","21215","Spencer County","Kentucky",205,144,191,-3,61,188,11.474629873,8.0602278134,10.690996614,-0.167921413,3.4144020598,10.523075201
"1102","21217","Taylor County","Kentucky",305,277,145,50,28,195,11.973697124,10.87447247,5.692413387,1.9629011679,1.099224654,7.6553145549
"1103","21219","Todd County","Kentucky",187,111,-65,2,76,-63,15.028530097,8.920678293,-5.223820622,0.1607329422,6.1078518042,-5.06308768
"1104","21221","Trigg County","Kentucky",146,162,102,1,-16,103,10.300186955,11.428974567,7.1960210237,0.0705492257,-1.128787612,7.2665702494
"1105","21223","Trimble County","Kentucky",99,100,14,-1,-1,13,11.322049405,11.436413541,1.6010978957,-0.114364135,-0.114364135,1.4867337603
"1106","21225","Union County","Kentucky",176,188,-101,-2,-12,-103,11.706019288,12.504156967,-6.717658796,-0.133022946,-0.798137679,-6.850681743
"1107","21227","Warren County","Kentucky",1657,958,1343,719,699,2062,13.505307985,7.8081382318,10.946064348,5.8601789025,5.6971697537,16.80624325
"1108","21229","Washington County","Kentucky",131,138,90,30,-7,120,10.947685108,11.532675915,7.5213103794,2.5071034598,-0.584990807,10.028413839
"1109","21231","Wayne County","Kentucky",249,268,8,0,-19,8,12.078583556,13.000242542,0.3880669415,0,-0.921658986,0.3880669415
"1110","21233","Webster County","Kentucky",172,166,-45,13,6,-32,13.038204973,12.583383869,-3.411158278,0.9854457247,0.4548211037,-2.425712553
"1111","21235","Whitley County","Kentucky",598,528,197,12,70,209,16.618266198,14.672984202,5.4745793328,0.3334769137,1.9452819964,5.8080562464
"1112","21237","Wolfe County","Kentucky",85,103,11,-1,-18,10,11.724946548,14.207876405,1.5173460239,-0.137940548,-2.482929857,1.3794054762
"1113","21239","Woodford County","Kentucky",273,253,240,14,20,254,10.613688937,9.8361293082,9.3307155492,0.5442917404,0.7775596291,9.8750072896
"1114","22001","Acadia Parish","Louisiana",901,676,-245,39,225,-206,14.376321353,10.786230005,-3.909210579,0.6222825003,3.5900913479,-3.286928079
"1115","22003","Allen Parish","Louisiana",310,270,-133,9,40,-124,12.068361428,10.511153502,-5.177716355,0.3503717834,1.5572079262,-4.827344571
"1116","22005","Ascension Parish","Louisiana",1713,758,1060,69,955,1129,14.476402956,6.4057871808,8.9579609653,0.5831125534,8.0706157753,9.5410735187
"1117","22007","Assumption Parish","Louisiana",265,218,-211,6,47,-205,11.537540545,9.4912597688,-9.186494547,0.2612273331,2.0462807758,-8.925267214
"1118","22009","Avoyelles Parish","Louisiana",561,451,-221,17,110,-204,13.669590643,10.989278752,-5.384990253,0.4142300195,2.6803118908,-4.970760234
"1119","22011","Beauregard Parish","Louisiana",497,360,104,45,137,149,13.657973563,9.8930995631,2.8580065404,1.2366374454,3.7648740004,4.0946439858
"1120","22013","Bienville Parish","Louisiana",181,207,66,2,-26,68,13.110716743,14.994024121,4.7807033429,0.1448697983,-1.883307377,4.9255731411
"1121","22015","Bossier Parish","Louisiana",1836,1024,-349,255,812,-94,14.661492022,8.1772155942,-2.786961174,2.0363183364,6.4842764282,-0.750642838
"1122","22017","Caddo Parish","Louisiana",3626,2728,-2312,167,898,-2145,14.389888187,10.826148641,-9.175240344,0.6627444366,3.5637395454,-8.512495907
"1123","22019","Calcasieu Parish","Louisiana",2766,2013,999,123,753,1122,14.005453316,10.19268891,5.0583687141,0.622802154,3.8127644061,5.681170868
"1124","22021","Caldwell Parish","Louisiana",143,124,75,1,19,76,14.300715036,12.400620031,7.5003750188,0.1000050003,1.9000950048,7.600380019
"1125","22023","Cameron Parish","Louisiana",72,50,78,-1,22,77,10.627306273,7.3800738007,11.512915129,-0.147601476,3.2472324723,11.365313653
"1126","22025","Catahoula Parish","Louisiana",117,155,-83,16,-38,-67,11.608294474,15.378509773,-8.234943943,1.5874590733,-3.770215299,-6.64748487
"1127","22027","Claiborne Parish","Louisiana",158,178,-119,1,-20,-118,9.6721863426,10.896513728,-7.284747942,0.0612163693,-1.224327385,-7.223531572
"1128","22029","Concordia Parish","Louisiana",267,252,-264,0,15,-264,13.116848026,12.379946452,-12.96946771,0,0.7369015745,-12.96946771
"1129","22031","De Soto Parish","Louisiana",363,296,-22,-1,67,-23,13.40002584,10.926742834,-0.812122778,-0.036914672,2.4732830063,-0.84903745
"1130","22033","East Baton Rouge Parish","Louisiana",6199,3826,-2982,891,2373,-2091,13.932278205,8.5989508651,-6.702057365,2.0025261947,5.33332734,-4.699531171
"1131","22035","East Carroll Parish","Louisiana",114,83,-197,-2,31,-199,15.491235222,11.278706346,-26.76994157,-0.271776057,4.2125288762,-27.04171762
"1132","22037","East Feliciana Parish","Louisiana",219,244,-109,0,-25,-109,11.158667074,12.432487517,-5.553857128,0,-1.273820442,-5.553857128
"1133","22039","Evangeline Parish","Louisiana",492,373,-223,61,119,-162,14.584475833,11.056929849,-6.610443315,1.8082378574,3.5275459841,-4.802205457
"1134","22041","Franklin Parish","Louisiana",278,270,-51,1,8,-50,13.62044046,13.228485338,-2.498713897,0.0489943901,0.3919551211,-2.449719507
"1135","22043","Grant Parish","Louisiana",239,207,-90,8,32,-82,10.70452815,9.271285887,-4.030993864,0.3583105657,1.4332422627,-3.672683298
"1136","22045","Iberia Parish","Louisiana",1160,732,-440,31,428,-409,15.728280397,9.9250872852,-5.965899461,0.4203247348,5.8031931121,-5.545574726
"1137","22047","Iberville Parish","Louisiana",397,353,-31,-8,44,-39,11.980927088,10.653066152,-0.935538387,-0.241429261,1.3278609367,-1.176967648
"1138","22049","Jackson Parish","Louisiana",199,177,-65,5,22,-60,12.462034631,11.084322259,-4.070513824,0.313116448,1.3777123712,-3.757397376
"1139","22051","Jefferson Parish","Louisiana",5999,4024,-2571,1766,1975,-805,13.800226822,9.2568949375,-5.914382924,4.0625438518,4.5433318841,-1.851839072
"1140","22053","Jefferson Davis Parish","Louisiana",453,364,-109,5,89,-104,14.408626091,11.577792268,-3.466976256,0.1590356081,2.8308338237,-3.307940648
"1141","22055","Lafayette Parish","Louisiana",3484,1754,1575,328,1730,1903,14.671604928,7.3863361204,6.6325424114,1.3812532768,7.2852688075,8.0137956882
"1142","22057","Lafourche Parish","Louisiana",1324,883,-108,97,441,-11,13.494437621,8.9996891387,-1.10075473,0.9886408227,4.4947484826,-0.112113908
"1143","22059","LaSalle Parish","Louisiana",172,141,65,15,31,80,11.520042865,9.4437560698,4.3535045712,1.004654901,2.0762867955,5.3581594722
"1144","22061","Lincoln Parish","Louisiana",590,390,-109,150,200,41,12.46882793,8.2421065979,-2.303563126,3.1700409992,4.2267213323,0.8664778731
"1145","22063","Livingston Parish","Louisiana",1864,1084,1158,4,780,1162,13.656678145,7.941973771,8.4841380321,0.0293061763,5.7147043739,8.5134442084
"1146","22065","Madison Parish","Louisiana",174,144,-301,0,30,-301,14.890248599,12.322964358,-25.75841855,0,2.5672842412,-25.75841855
"1147","22067","Morehouse Parish","Louisiana",375,389,-338,4,-14,-334,14.160561891,14.689222868,-12.76338645,0.1510459935,-0.528660977,-12.61234046
"1148","22069","Natchitoches Parish","Louisiana",504,397,-251,25,107,-226,12.904382113,10.164761307,-6.426587124,0.6400983191,2.7396208058,-5.786488805
"1149","22071","Orleans Parish","Louisiana",5046,3186,2980,975,1860,3955,13.043461403,8.2355267596,7.7030350734,2.520288321,4.8079346431,10.223323394
"1150","22073","Ouachita Parish","Louisiana",2301,1534,-314,94,767,-220,14.692173114,9.7947820757,-2.004929317,0.60020177,4.8973910378,-1.404727547
"1151","22075","Plaquemines Parish","Louisiana",311,178,-38,38,133,0,13.303390012,7.6141589135,-1.6254946,1.6254945995,5.6892310983,0
"1152","22077","Pointe Coupee Parish","Louisiana",280,295,-92,9,-15,-83,12.579746608,13.253661605,-4.133345314,0.4043489981,-0.673914997,-3.728996316
"1153","22079","Rapides Parish","Louisiana",1881,1489,-851,59,392,-792,14.249568195,11.279961213,-6.44677434,0.4469561528,2.9696069816,-5.999818187
"1154","22081","Red River Parish","Louisiana",122,120,-57,11,2,-46,13.963603067,13.734691542,-6.523978482,1.2590133913,0.2289115257,-5.264965091
"1155","22083","Richland Parish","Louisiana",244,235,-223,-1,9,-224,11.81197657,11.376288909,-10.79537203,-0.04840974,0.4356876604,-10.84378177
"1156","22085","Sabine Parish","Louisiana",284,286,94,7,-2,101,11.751805185,11.834564376,3.8896819978,0.28965717,-0.082759191,4.1793391679
"1157","22087","St. Bernard Parish","Louisiana",651,346,600,76,305,676,14.488238043,7.7003538602,13.353214786,1.6914072063,6.7878841831,15.044621993
"1158","22089","St. Charles Parish","Louisiana",660,426,-379,45,234,-334,12.540137942,8.094089035,-7.201079212,0.8550094051,4.4460489065,-6.346069807
"1159","22091","St. Helena Parish","Louisiana",118,122,-60,10,-4,-50,11.241842519,11.622921926,-5.716191111,0.9526985186,-0.381079407,-4.763492593
"1160","22093","St. James Parish","Louisiana",271,201,-106,1,70,-105,12.605823798,9.3497069495,-4.930691227,0.046515955,3.2561168481,-4.884175272
"1161","22095","St. John the Baptist Parish","Louisiana",580,400,-421,58,180,-363,13.292843637,9.1674783705,-9.648770985,1.3292843637,4.1253652667,-8.319486621
"1162","22097","St. Landry Parish","Louisiana",1276,1002,-298,-13,274,-311,15.253852315,11.978338573,-3.562420055,-0.155407586,3.2755137416,-3.717827641
"1163","22099","St. Martin Parish","Louisiana",779,478,240,47,301,287,14.53602284,8.9194081096,4.4783639044,0.8770129313,5.6166147301,5.3553768357
"1164","22101","St. Mary Parish","Louisiana",804,555,-720,63,249,-657,15.146377303,10.455521646,-13.56391997,1.1868429976,4.6908556573,-12.37707698
"1165","22103","St. Tammany Parish","Louisiana",2953,2161,2728,158,792,2886,11.951957421,8.7464205851,11.041293547,0.6394884093,3.2055368364,11.680781957
"1166","22105","Tangipahoa Parish","Louisiana",1924,1203,954,38,721,992,15.045237369,9.4071832407,7.460060525,0.2971512578,5.6380541284,7.7572117828
"1167","22107","Tensas Parish","Louisiana",56,49,-89,0,7,-89,11.635154789,10.18076044,-18.49158529,0,1.4543943486,-18.49158529
"1168","22109","Terrebonne Parish","Louisiana",1757,1091,-379,46,666,-333,15.462057677,9.6010841921,-3.335298725,0.4048119824,5.8609734848,-2.930486742
"1169","22111","Union Parish","Louisiana",278,262,-90,8,16,-82,12.341020576,11.63074601,-3.995294431,0.3551372828,0.7102745655,-3.640157148
"1170","22113","Vermilion Parish","Louisiana",835,595,131,20,240,151,13.977702635,9.9601593625,2.1929090361,0.3347952727,4.0175432723,2.5277043088
"1171","22115","Vernon Parish","Louisiana",1017,402,-2314,293,615,-2021,19.518654998,7.7153385537,-44.41117764,5.6233686473,11.803316444,-38.787809
"1172","22117","Washington Parish","Louisiana",620,601,38,-7,19,31,13.377637768,12.967677901,0.8199197342,-0.151037846,0.4099598671,0.6688818884
"1173","22119","Webster Parish","Louisiana",512,478,-270,13,34,-257,12.746306185,11.89987179,-6.721684902,0.3236366805,0.8464343951,-6.398048222
"1174","22121","West Baton Rouge Parish","Louisiana",397,231,205,-9,166,196,15.642854328,9.1020134757,8.0775444265,-0.354623902,6.5408408527,7.7229205248
"1175","22123","West Carroll Parish","Louisiana",146,146,-248,6,0,-242,12.800280554,12.800280554,-21.74294231,0.5260389269,0,-21.21690338
"1176","22125","West Feliciana Parish","Louisiana",112,120,1,-2,-8,-1,7.2864485069,7.8069091146,0.065057576,-0.130115152,-0.520460608,-0.065057576
"1177","22127","Winn Parish","Louisiana",166,170,-171,-2,-4,-173,11.267605634,11.539114203,-11.60699135,-0.135754285,-0.271508569,-11.74274563
"1178","23001","Androscoggin County","Maine",1265,1121,-491,93,144,-398,11.791023908,10.448804586,-4.576595051,0.866849979,1.3422193224,-3.709745072
"1179","23003","Aroostook County","Maine",654,910,-467,25,-256,-442,9.4503207907,13.149528929,-6.748164846,0.3612507948,-3.699208138,-6.386914051
"1180","23005","Cumberland County","Maine",2769,2634,926,368,135,1294,9.5866057565,9.119219777,3.2059216073,1.2740595588,0.4673859795,4.4799811661
"1181","23007","Franklin County","Maine",259,333,-103,-5,-74,-108,8.5903814262,11.044776119,-3.416252073,-0.165837479,-2.454394693,-3.582089552
"1182","23009","Hancock County","Maine",481,611,-159,36,-130,-123,8.8462210452,11.237091598,-2.924218599,0.66208723,-2.390870553,-2.262131369
"1183","23011","Kennebec County","Maine",1243,1334,-138,14,-91,-124,10.262507173,11.013825075,-1.139361215,0.1155873696,-0.751317902,-1.023773845
"1184","23013","Knox County","Maine",352,491,34,10,-139,44,8.8344543721,12.323059934,0.8533279791,0.2509788174,-3.488605562,1.1043067965
"1185","23015","Lincoln County","Maine",259,431,-101,12,-172,-89,7.6365137398,12.707866494,-2.977945512,0.3538153084,-5.071352754,-2.624130204
"1186","23017","Oxford County","Maine",478,648,10,9,-170,19,8.3580314912,11.330553151,0.1748542153,0.1573687938,-2.97252166,0.3322230091
"1187","23019","Penobscot County","Maine",1437,1584,-1140,10,-147,-1130,9.4176090283,10.380997008,-7.471172089,0.0655365973,-0.96338798,-7.405635492
"1188","23021","Piscataquis County","Maine",132,236,-3,1,-104,-2,7.7745383868,13.899932267,-0.176694054,0.0588980181,-6.12539388,-0.117796036
"1189","23023","Sagadahoc County","Maine",343,392,98,-5,-49,93,9.7734720046,11.169682291,2.7924205727,-0.142470437,-1.396210286,2.6499501353
"1190","23025","Somerset County","Maine",447,589,-365,-2,-142,-367,8.7669405927,11.551964226,-7.158687509,-0.039225685,-2.785023633,-7.197913194
"1191","23027","Waldo County","Maine",331,412,152,22,-81,174,8.4695888027,10.542207211,3.8893580001,0.5629333947,-2.072618408,4.4522913948
"1192","23029","Washington County","Maine",329,419,-117,18,-90,-99,10.308147823,13.12800589,-3.665815487,0.5639716134,-2.819858067,-3.101843874
"1193","23031","York County","Maine",1873,2033,594,15,-160,609,9.3159283474,10.111736428,2.9544375005,0.0746070076,-0.795808081,3.0290445081
"1194","24001","Allegany County","Maryland",635,964,-295,83,-329,-212,8.7303824182,13.253682915,-4.05584695,1.1411365996,-4.523300497,-2.914710351
"1195","24003","Anne Arundel County","Maryland",6964,4193,-266,1379,2771,1113,12.400362182,7.4662146221,-0.473649676,2.4554996336,4.9341475597,1.9818499581
"1196","24005","Baltimore County","Maryland",10071,8128,-2594,3190,1943,596,12.188974491,9.8373532582,-3.139529325,3.8608706808,2.3516212329,0.721341356
"1197","24009","Calvert County","Maryland",881,662,-383,83,219,-300,9.734107495,7.314391784,-4.231740262,0.9170612055,2.419715711,-3.314679056
"1198","24011","Caroline County","Maryland",413,344,-74,65,69,-9,12.683106593,10.564137211,-2.272517888,1.9961305776,2.1189693824,-0.276387311
"1199","24013","Carroll County","Maryland",1663,1544,-369,71,119,-298,9.9446853042,9.2330692181,-2.206607864,0.4245776648,0.7116160861,-1.782030199
"1200","24015","Cecil County","Maryland",1018,910,15,107,108,122,9.950200128,8.8945796822,0.1466139508,1.0458461824,1.0556204458,1.1924601332
"1201","24017","Charles County","Maryland",1901,960,181,211,941,392,12.261945076,6.1922500121,1.1674971377,1.3610049506,6.0696950639,2.5285020883
"1202","24019","Dorchester County","Maryland",380,387,-135,55,-7,-80,11.710504014,11.926223825,-4.160310637,1.6949413704,-0.215719811,-2.465369266
"1203","24021","Frederick County","Maryland",2828,1815,-95,806,1013,711,11.577566214,7.4304394194,-0.388921072,3.2996882491,4.1471267944,2.9107671775
"1204","24023","Garrett County","Maryland",285,284,-224,8,1,-216,9.647281836,9.6134317243,-7.582425022,0.2708008936,0.0338501117,-7.311624128
"1205","24025","Harford County","Maryland",2820,2006,-885,338,814,-547,11.3044402,8.0413854754,-3.547670063,1.3549293573,3.2630547243,-2.192740705
"1206","24027","Howard County","Maryland",3645,1623,869,1593,2022,2462,11.787590529,5.2486308447,2.8102650672,5.1516136387,6.5389596845,7.9618787059
"1207","24029","Kent County","Maryland",158,253,24,17,-95,41,8.0032418195,12.815317597,1.2156823017,0.861108297,-4.812075778,2.0767905987
"1208","24031","Montgomery County","Maryland",13176,6112,-8801,10086,7064,1285,12.794649087,5.9351013371,-8.546274029,9.7940824748,6.8595477496,1.2478084454
"1209","24033","Prince George's County","Maryland",12496,5612,-6643,6303,6884,-340,13.846290222,6.2184203528,-7.360827941,6.98408829,7.6278698697,-0.376739651
"1210","24035","Queen Anne's County","Maryland",438,417,127,56,21,183,8.9585208214,8.5290026998,2.5975619733,1.1453816575,0.4295181216,3.7429436309
"1211","24037","St. Mary's County","Maryland",1516,781,149,168,735,317,13.726226963,7.071360988,1.3490816738,1.5211122228,6.6548659746,2.8701938965
"1212","24039","Somerset County","Maryland",246,275,97,41,-29,138,9.5979399544,10.729404421,3.7845535592,1.5996566591,-1.131464466,5.3842102183
"1213","24041","Talbot County","Maryland",316,457,26,5,-141,31,8.4330758043,12.195935578,0.6938606674,0.1334347437,-3.762859773,0.8272954112
"1214","24043","Washington County","Maryland",1739,1541,-370,236,198,-134,11.664251985,10.336177291,-2.481755742,1.5829577162,1.3280746941,-0.898798025
"1215","24045","Wicomico County","Maryland",1201,920,-203,363,281,160,11.822727989,9.0565443377,-1.998346196,3.5733973854,2.766183651,1.5750511892
"1216","24047","Worcester County","Maryland",438,659,56,24,-221,80,8.5051020904,12.796489218,1.0874103129,0.4660329913,-4.291387128,1.5534433042
"1217","24510","Baltimore city","Maryland",8930,6313,-5887,2278,2617,-3609,14.34175289,10.138800223,-9.454635976,3.6585121034,4.2029526666,-5.796123872
"1218","25001","Barnstable County","Massachusetts",1481,3000,717,339,-1519,1056,6.9187825559,14.01508958,3.3496064096,1.5837051225,-7.096307024,4.9333115321
"1219","25003","Berkshire County","Massachusetts",1076,1475,-907,319,-399,-588,8.383261525,11.491924488,-7.066559668,2.4853721436,-3.108662963,-4.581187525
"1220","25005","Bristol County","Massachusetts",5664,5428,198,1323,236,1521,10.186280892,9.7618525219,0.3560882092,2.3793166703,0.4244283705,2.7354048795
"1221","25007","Dukes County","Massachusetts",175,140,-58,0,35,-58,10.123213976,8.0985711807,-3.355122346,0,2.0246427952,-3.355122346
"1222","25009","Essex County","Massachusetts",8550,6826,-823,4590,1724,3767,11.039715214,8.8136954446,-1.062653289,5.926583957,2.2260197695,4.863930668
"1223","25011","Franklin County","Massachusetts",598,729,-458,198,-131,-260,8.4108666146,10.253380873,-6.441767407,2.7848688791,-1.842514258,-3.656898528
"1224","25013","Hampden County","Massachusetts",5176,4469,-3516,2525,707,-991,11.027582805,9.5213036239,-7.490915986,5.3795685053,1.5062791815,-2.111347481
"1225","25015","Hampshire County","Massachusetts",1048,1265,-620,681,-217,61,6.5155490345,7.8646655807,-3.854618704,4.233863447,-1.349116546,0.3792447434
"1226","25017","Middlesex County","Massachusetts",17504,11465,-7188,11811,6039,4623,11.07493423,7.2540059955,-4.547910606,7.4729232284,3.8209282344,2.9250126225
"1227","25019","Nantucket County","Massachusetts",141,80,-35,81,61,46,12.94528094,7.3448402497,-3.213367609,7.4366507528,5.6004406904,4.2232831436
"1228","25021","Norfolk County","Massachusetts",7336,5957,-2465,3507,1379,1042,10.576808013,8.5886103233,-3.553957436,5.0562794031,1.9881976894,1.5023219669
"1229","25023","Plymouth County","Massachusetts",5243,4660,771,1301,583,2072,10.323802735,9.1758384029,1.5181483709,2.5617523095,1.1479643324,4.0799006804
"1230","25025","Suffolk County","Massachusetts",9481,4773,-5629,10099,4708,4470,12.180105229,6.1318048999,-7.231495869,12.974040998,6.0483003287,5.7425451294
"1231","25027","Worcester County","Massachusetts",8451,7209,-2178,3753,1242,1575,10.343941248,8.82374541,-2.665850673,4.5936352509,1.5201958384,1.9277845777
"1232","26001","Alcona County","Michigan",52,198,25,1,-146,26,5.0055349665,19.059536988,2.4065071955,0.0962602878,-14.05400202,2.5027674833
"1233","26003","Alger County","Michigan",58,139,-29,1,-81,-28,6.2325381474,14.936600043,-3.116269074,0.1074575543,-8.704061896,-3.008811519
"1234","26005","Allegan County","Michigan",1392,1047,394,53,345,447,12.237739183,9.2046788253,3.4638428435,0.4659484028,3.0330603579,3.9297912463
"1235","26007","Alpena County","Michigan",276,368,-73,1,-92,-72,9.5823351734,12.776446898,-2.534458216,0.0347186057,-3.194111724,-2.49973961
"1236","26009","Antrim County","Michigan",210,291,-33,5,-81,-28,9.0952401577,12.603404218,-1.429252025,0.2165533371,-3.508164061,-1.212698688
"1237","26011","Arenac County","Michigan",147,182,21,2,-35,23,9.6018811849,11.888043372,1.3716973121,0.1306378393,-2.286162187,1.5023351514
"1238","26013","Baraga County","Michigan",81,93,-57,5,-12,-52,9.4016597992,10.794498288,-6.615982822,0.5803493703,-1.392838489,-6.035633451
"1239","26015","Barry County","Michigan",655,546,7,16,109,23,11.035482023,9.19904303,0.1179364491,0.2695690265,1.8364389932,0.3875054756
"1240","26017","Bay County","Michigan",1031,1281,-545,16,-250,-529,9.7564668531,12.122244461,-5.157395184,0.1514097669,-2.365777607,-5.005985417
"1241","26019","Benzie County","Michigan",154,209,-22,-2,-55,-24,8.8335675567,11.988413113,-1.261938222,-0.114721657,-3.154845556,-1.376659879
"1242","26021","Berrien County","Michigan",1792,1843,-1238,372,-51,-866,11.521892882,11.849803896,-7.959879123,2.3918215135,-0.327911014,-5.568057609
"1243","26023","Branch County","Michigan",519,475,-176,57,44,-119,11.878604779,10.871555433,-4.028197382,1.304586652,1.0070493454,-2.72361073
"1244","26025","Calhoun County","Michigan",1670,1448,-987,292,222,-695,12.409391011,10.759759392,-7.334173011,2.1697857337,1.6496316194,-5.164387277
"1245","26027","Cass County","Michigan",513,567,-171,2,-54,-169,9.9702641245,11.019765611,-3.323421375,0.0388704254,-1.049501487,-3.284550949
"1246","26029","Charlevoix County","Michigan",239,289,20,30,-50,50,9.1170916859,11.024433043,0.7629365428,1.1444048141,-1.907341357,1.9073413569
"1247","26031","Cheboygan County","Michigan",212,326,-128,1,-114,-127,8.3088379385,12.776797962,-5.016656869,0.0391926318,-4.467960024,-4.977464237
"1248","26033","Chippewa County","Michigan",375,373,-303,38,2,-265,9.8396788329,9.7872005458,-7.950460497,0.9970874551,0.0524782871,-6.953373042
"1249","26035","Clare County","Michigan",342,443,-17,6,-101,-11,11.150780066,14.443846693,-0.554278541,0.1956277204,-3.293066628,-0.358650821
"1250","26037","Clinton County","Michigan",807,609,-224,77,198,-147,10.481948837,7.9101695686,-2.909487657,1.0001363822,2.5717792686,-1.909351275
"1251","26039","Crawford County","Michigan",136,172,142,6,-36,148,9.8572153367,12.46647822,10.292092484,0.4348771472,-2.609262883,10.726969631
"1252","26041","Delta County","Michigan",375,441,-93,-2,-66,-95,10.274254089,12.082522809,-2.548015014,-0.054796022,-1.80826872,-2.602811036
"1253","26043","Dickinson County","Michigan",218,332,-126,-2,-114,-128,8.4573157721,12.879948791,-4.888173336,-0.077590053,-4.422633018,-4.965763389
"1254","26045","Eaton County","Michigan",1178,997,-313,145,181,-168,10.841804452,9.1759584367,-2.880717142,1.3345175259,1.6658460151,-1.546199616
"1255","26047","Emmet County","Michigan",292,373,19,15,-81,34,8.8635259835,11.322243808,0.5767362797,0.4553181156,-2.458717824,1.0320543953
"1256","26049","Genesee County","Michigan",4817,4698,-2712,200,119,-2512,11.701148253,11.412081065,-6.587816911,0.4858272058,0.2890671875,-6.101989705
"1257","26051","Gladwin County","Michigan",293,348,-222,2,-55,-220,11.55362776,13.722397476,-8.753943218,0.0788643533,-2.168769716,-8.675078864
"1258","26053","Gogebic County","Michigan",128,192,-159,4,-64,-155,8.1810047296,12.271507094,-10.16234181,0.2556563978,-4.090502365,-9.906685415
"1259","26055","Grand Traverse County","Michigan",935,861,600,20,74,620,10.25224919,9.4408412327,6.5789834374,0.2192994479,0.8114079573,6.7982828853
"1260","26057","Gratiot County","Michigan",420,468,-98,6,-48,-92,10.147256013,11.306942414,-2.36769307,0.1449608002,-1.159686401,-2.222732269
"1261","26059","Hillsdale County","Michigan",543,494,-101,5,49,-96,11.830709734,10.763113459,-2.200555586,0.1089383953,1.0675962743,-2.09161719
"1262","26061","Houghton County","Michigan",363,350,-366,163,13,-203,9.9792442716,9.6218608679,-10.06171736,4.4810380613,0.3573834037,-5.580679303
"1263","26063","Huron County","Michigan",296,488,-93,8,-192,-85,9.2794332022,15.298525009,-2.915497594,0.250795492,-6.019091807,-2.664702102
"1264","26065","Ingham County","Michigan",3340,2201,-1579,1963,1139,384,11.661563278,7.684760711,-5.513056412,6.8537870403,3.9768025669,1.3407306284
"1265","26067","Ionia County","Michigan",738,522,-404,2,216,-402,11.50634954,8.1386374798,-6.298868854,0.0311825191,3.3677120606,-6.267686335
"1266","26069","Iosco County","Michigan",255,437,87,6,-182,93,10.048271106,17.219978327,3.4282336716,0.2364299084,-7.171707221,3.6646635799
"1267","26071","Iron County","Michigan",97,172,50,0,-75,50,8.5613415711,15.180935569,4.4130626655,0,-6.619593998,4.4130626655
"1268","26073","Isabella County","Michigan",720,478,228,216,242,444,10.221537632,6.785965261,3.23682025,3.0664612895,3.4355723706,6.3032815395
"1269","26075","Jackson County","Michigan",1826,1638,-396,77,188,-319,11.458009783,10.278324219,-2.484869591,0.4831690872,1.1796855636,-2.001700504
"1270","26077","Kalamazoo County","Michigan",3205,2162,-705,436,1043,-269,12.358341784,8.3365787637,-2.718449597,1.6811971975,4.0217630206,-1.037252399
"1271","26079","Kalkaska County","Michigan",176,189,-109,10,-13,-99,10.168414363,10.919490424,-6.297483895,0.5777508161,-0.751076061,-5.719733079
"1272","26081","Kent County","Michigan",8873,4745,368,1429,4128,1797,13.986939953,7.4797734787,0.5800962361,2.2526019602,6.5071664742,2.8326981963
"1273","26083","Keweenaw County","Michigan",17,15,-53,0,2,-53,7.912497091,6.9816150803,-24.66837328,0,0.9308820107,-24.66837328
"1274","26085","Lake County","Michigan",86,157,355,8,-71,363,7.4491121698,13.598960589,30.749242096,0.692940667,-6.149848419,31.442182763
"1275","26087","Lapeer County","Michigan",857,851,153,38,6,191,9.7063187342,9.6383631771,1.7328667052,0.4303851947,0.0679555571,2.1632518999
"1276","26089","Leelanau County","Michigan",174,245,96,15,-71,111,8.0488481821,11.333148302,4.4407438246,0.6938662226,-3.28430012,5.1346100472
"1277","26091","Lenawee County","Michigan",1036,1065,-355,36,-29,-319,10.511256988,10.805491016,-3.601830339,0.3652560343,-0.294234028,-3.236574304
"1278","26093","Livingston County","Michigan",1819,1415,1181,84,404,1265,9.7607306328,7.5928718227,6.3372308287,0.4507429209,2.1678588101,6.7879737496
"1279","26095","Luce County","Michigan",59,61,17,3,-2,20,9.1893154739,9.5008176933,2.6477688654,0.4672533292,-0.311502219,3.1150221945
"1280","26097","Mackinac County","Michigan",87,155,-136,22,-68,-114,7.9725085911,14.203894616,-12.46277205,2.0160366552,-6.231386025,-10.4467354
"1281","26099","Macomb County","Michigan",9353,8885,-693,2465,468,1772,10.824949582,10.283297021,-0.802062446,2.8529349641,0.5416525611,2.0508725178
"1282","26101","Manistee County","Michigan",177,310,169,6,-133,175,7.2457835271,12.69035533,6.9182904863,0.2456197806,-5.444571803,7.1639102669
"1283","26103","Marquette County","Michigan",621,683,-434,44,-62,-390,9.1937346401,10.111627632,-6.42525094,0.6514079294,-0.917892991,-5.773843011
"1284","26105","Mason County","Michigan",320,349,32,10,-29,42,11.135663703,12.144833226,1.1135663703,0.3479894907,-1.009169523,1.461555861
"1285","26107","Mecosta County","Michigan",412,390,-249,59,22,-190,9.5566148244,9.0463101493,-5.775721095,1.3685443559,0.5103046751,-4.407176739
"1286","26109","Menominee County","Michigan",248,286,-5,-4,-38,-9,10.557234686,12.174875484,-0.212847474,-0.170277979,-1.617640799,-0.383125452
"1287","26111","Midland County","Michigan",892,700,-152,109,192,-43,10.675922324,8.3779659496,-1.819215463,1.3045689836,2.2979563747,-0.51464648
"1288","26113","Missaukee County","Michigan",161,178,-83,10,-17,-73,10.783657066,11.922304086,-5.559276624,0.6697923644,-1.138647019,-4.88948426
"1289","26115","Monroe County","Michigan",1502,1412,-584,33,90,-551,10.038831967,9.4373040857,-3.903247582,0.220560223,0.6015278808,-3.682687359
"1290","26117","Montcalm County","Michigan",680,590,-137,11,90,-126,10.830784913,9.3972986748,-2.182084608,0.1752038736,1.4334862385,-2.006880734
"1291","26119","Montmorency County","Michigan",61,134,36,3,-73,39,6.5559675426,14.401633618,3.8690955989,0.3224246332,-7.845666076,4.1915202321
"1292","26121","Muskegon County","Michigan",2099,1768,-169,59,331,-110,12.177716925,10.257362326,-0.980483164,0.3422988559,1.9203545984,-0.638184308
"1293","26123","Newaygo County","Michigan",575,494,12,15,81,27,12.020110167,10.326842474,0.250854473,0.3135680913,1.6932676931,0.5644225644
"1294","26125","Oakland County","Michigan",13487,10692,-6739,5710,2795,-1029,10.842929866,8.5958779662,-5.417847139,4.5905783003,2.2470519001,-0.827268839
"1295","26127","Oceana County","Michigan",297,296,-61,39,1,-22,11.275626424,11.237661352,-2.3158694,1.4806378132,0.0379650721,-0.835231587
"1296","26129","Ogemaw County","Michigan",186,313,40,19,-127,59,8.8863408342,14.953896135,1.9110410396,0.9077444938,-6.067555301,2.8187855334
"1297","26131","Ontonagon County","Michigan",28,112,-74,4,-84,-70,4.5792787636,18.317115054,-12.10237959,0.6541826805,-13.73783629,-11.44819691
"1298","26133","Osceola County","Michigan",255,226,-69,9,29,-60,10.993985643,9.7436892367,-2.974843174,0.3880230227,1.2502964065,-2.586820151
"1299","26135","Oscoda County","Michigan",97,108,-22,0,-11,-22,11.694496353,13.020676352,-2.652359998,0,-1.326179999,-2.652359998
"1300","26137","Otsego County","Michigan",268,262,89,16,6,105,11.09409281,10.845717597,3.6842323136,0.6623338991,0.2483752122,4.3465662127
"1301","26139","Ottawa County","Michigan",3331,1893,1244,414,1438,1658,11.920951672,6.77465071,4.4520155749,1.4816193312,5.146300962,5.9336349061
"1302","26141","Presque Isle County","Michigan",102,197,-68,3,-95,-65,7.9223300971,15.300970874,-5.281553398,0.2330097087,-7.378640777,-5.048543689
"1303","26143","Roscommon County","Michigan",178,399,115,1,-221,116,7.4267236883,16.647543549,4.7981641807,0.0417231668,-9.22081986,4.8398873474
"1304","26145","Saginaw County","Michigan",2163,2089,-2238,210,74,-2028,11.133186469,10.752300756,-11.51921929,1.0808918902,0.3808857137,-10.4383274
"1305","26147","St. Clair County","Michigan",1570,1771,-170,51,-201,-119,9.8175928763,11.074494894,-1.063051458,0.3189154374,-1.256902018,-0.744136021
"1306","26149","St. Joseph County","Michigan",834,664,-394,22,170,-372,13.693007372,10.901866781,-6.468878782,0.3612064295,2.7911405914,-6.107672353
"1307","26151","Sanilac County","Michigan",417,489,-136,5,-72,-131,10.036221856,11.769094694,-3.27320425,0.1203383916,-1.732872838,-3.152865859
"1308","26153","Schoolcraft County","Michigan",56,102,33,0,-46,33,6.8880688807,12.546125461,4.0590405904,0,-5.658056581,4.0590405904
"1309","26155","Shiawassee County","Michigan",707,749,-276,6,-42,-270,10.299816439,10.911686722,-4.020861863,0.0874100405,-0.611870283,-3.933451822
"1310","26157","Tuscola County","Michigan",585,594,-195,7,-9,-188,10.867344095,11.034534005,-3.622448032,0.130036596,-0.167189909,-3.492411436
"1311","26159","Van Buren County","Michigan",884,768,-320,35,116,-285,11.763140386,10.219560878,-4.258150366,0.4657351963,1.5435795077,-3.79241517
"1312","26161","Washtenaw County","Michigan",3652,2168,-490,2125,1484,1635,10.100339628,5.9960395163,-1.355193433,5.8771143783,4.1043001117,4.5219209452
"1313","26163","Wayne County","Michigan",23287,18474,-16187,4095,4813,-12092,13.168933261,10.447153908,-9.153842174,2.3157461976,2.7217793526,-6.838095976
"1314","26165","Wexford County","Michigan",424,374,-19,13,50,-6,12.897730729,11.376771917,-0.577964349,0.3954492912,1.5209588124,-0.182515057
"1315","27001","Aitkin County","Minnesota",106,209,106,3,-103,109,6.6870643157,13.184872094,6.6870643157,0.1892565372,-6.497807778,6.8763208529
"1316","27003","Anoka County","Minnesota",4122,2032,-264,539,2090,275,12.014742982,5.9228427313,-0.76950319,1.5710690119,6.0919002502,0.8015658224
"1317","27005","Becker County","Minnesota",398,341,91,42,57,133,11.934390836,10.225194159,2.7287175028,1.2594080782,1.7091966776,3.988125581
"1318","27007","Beltrami County","Minnesota",621,421,-288,59,200,-229,13.612599875,9.2285097382,-6.313089797,1.2933065904,4.3840901369,-5.019783207
"1319","27009","Benton County","Minnesota",624,333,-83,66,291,-17,15.887362672,8.4783521953,-2.11322292,1.6803941288,7.409010477,-0.432828791
"1320","27011","Big Stone County","Minnesota",52,74,-74,1,-22,-73,10.318483977,14.683996428,-14.68399643,0.1984323842,-4.365512452,-14.48556404
"1321","27013","Blue Earth County","Minnesota",699,488,-27,187,211,160,10.675504376,7.4529987629,-0.412358538,2.8559646899,3.2225056127,2.4436061518
"1322","27015","Brown County","Minnesota",262,312,5,14,-50,19,10.374594124,12.354478498,0.1979884375,0.5543676249,-1.979884375,0.7523560624
"1323","27017","Carlton County","Minnesota",363,395,60,16,-32,76,10.258004352,11.162291237,1.6955379094,0.4521434425,-0.904286885,2.1476813519
"1324","27019","Carver County","Minnesota",1173,468,495,83,705,578,11.969509893,4.7755589343,5.0510719497,0.8469474178,7.1939509587,5.8980193675
"1325","27021","Cass County","Minnesota",360,348,113,11,12,124,12.578836108,12.159541571,3.9483568895,0.3843533255,0.4192945369,4.3327102151
"1326","27023","Chippewa County","Minnesota",164,155,-17,35,9,18,13.594727898,12.848675757,-1.409209599,2.9013138807,0.7460521408,1.4921042815
"1327","27025","Chisago County","Minnesota",563,438,188,9,125,197,10.434621444,8.1178760078,3.4843851358,0.1668056714,2.316745436,3.6511908072
"1328","27027","Clay County","Minnesota",872,466,376,132,406,508,14.134733839,7.5536536342,6.0947934902,2.1396615444,6.5810802049,8.2344550347
"1329","27029","Clearwater County","Minnesota",115,118,5,7,-3,12,13.079328974,13.42052886,0.5686664771,0.796133068,-0.341199886,1.3647995451
"1330","27031","Cook County","Minnesota",50,43,-41,20,7,-21,9.5520106983,8.2147292005,-7.832648773,3.8208042793,1.3372814978,-4.011844493
"1331","27033","Cottonwood County","Minnesota",151,142,-97,8,9,-89,13.169370312,12.384440956,-8.459794174,0.6977149834,0.7849293564,-7.762079191
"1332","27035","Crow Wing County","Minnesota",703,652,63,27,51,90,11.129581255,10.322172089,0.9973877939,0.4274519117,0.8074091665,1.4248397055
"1333","27037","Dakota County","Minnesota",5307,2461,-1323,939,2846,-384,12.849412249,5.9586213576,-3.203273489,2.2735251746,6.8907908914,-0.929748314
"1334","27039","Dodge County","Minnesota",268,163,-90,22,105,-68,13.137898917,7.9905877739,-4.411980979,1.0784842394,5.1473111427,-3.33349674
"1335","27041","Douglas County","Minnesota",423,397,188,4,26,192,11.533742331,10.824812543,5.1261077028,0.1090661213,0.7089297887,5.2351738241
"1336","27043","Faribault County","Minnesota",149,190,-86,0,-41,-86,10.609890697,13.529390821,-6.12382953,0,-2.919500125,-6.12382953
"1337","27045","Fillmore County","Minnesota",242,246,-63,27,-4,-36,11.663774822,11.856564488,-3.036437247,1.3013302487,-0.192789666,-1.735106998
"1338","27047","Freeborn County","Minnesota",325,424,-167,23,-99,-144,10.614324439,13.847610961,-5.454129789,0.7511675757,-3.233286521,-4.702962213
"1339","27049","Goodhue County","Minnesota",502,470,-11,36,32,25,10.901904576,10.206962451,-0.238886355,0.7818098899,0.6949421244,0.5429235346
"1340","27051","Grant County","Minnesota",81,68,-70,0,13,-70,13.733468973,11.529331977,-11.86842998,0,2.2041369956,-11.86842998
"1341","27053","Hennepin County","Minnesota",16751,8509,-3411,6647,8242,3236,13.765067741,6.9922369653,-2.802975707,5.4621458583,6.7728307754,2.6591701516
"1342","27055","Houston County","Minnesota",208,212,-18,5,-4,-13,11.12894596,11.342964152,-0.963081862,0.2675227394,-0.214018192,-0.695559123
"1343","27057","Hubbard County","Minnesota",211,217,9,10,-6,19,10.223363535,10.514075294,0.4360676389,0.4845195988,-0.290711759,0.9205872378
"1344","27059","Isanti County","Minnesota",455,310,-162,25,145,-137,11.888276331,8.0997047527,-4.232748935,0.6532019962,3.7885715779,-3.579546939
"1345","27061","Itasca County","Minnesota",506,590,12,18,-84,30,11.172197567,13.026870681,0.264953302,0.397429953,-1.854673114,0.662383255
"1346","27063","Jackson County","Minnesota",123,111,-203,11,12,-192,12.077769049,10.899450118,-19.93322859,1.0801256874,1.1783189317,-18.85310291
"1347","27065","Kanabec County","Minnesota",177,159,-113,9,18,-104,11.112855125,9.9827342646,-7.094647622,0.5650604301,1.1301208601,-6.529587192
"1348","27067","Kandiyohi County","Minnesota",598,427,-297,226,171,-71,14.057027338,10.037375708,-6.9815002,5.3125220376,4.0196516302,-1.668978162
"1349","27069","Kittson County","Minnesota",45,76,-21,1,-31,-20,10.158013544,17.155756208,-4.740406321,0.2257336343,-6.997742664,-4.514672686
"1350","27071","Koochiching County","Minnesota",102,126,-32,7,-24,-25,7.9544568354,9.8260937378,-2.49551587,0.5458940965,-1.871636902,-1.949621773
"1351","27073","Lac qui Parle County","Minnesota",61,72,-21,4,-11,-17,8.8579104044,10.45523851,-3.049444565,0.5808465839,-1.597328106,-2.468597982
"1352","27075","Lake County","Minnesota",104,141,-29,15,-37,-14,9.835910531,13.335224855,-2.742705821,1.418640942,-3.499314324,-1.324064879
"1353","27077","Lake of the Woods County","Minnesota",28,46,-2,4,-18,2,7.2155650045,11.854142507,-0.5153975,1.0307950006,-4.638577503,0.5153975003
"1354","27079","Le Sueur County","Minnesota",318,239,-171,16,79,-155,11.44955714,8.6051703032,-6.15683733,0.5760783467,2.8443868366,-5.580758983
"1355","27081","Lincoln County","Minnesota",73,95,-33,0,-22,-33,12.721094363,16.554848828,-5.750631698,0,-3.833754465,-5.750631698
"1356","27083","Lyon County","Minnesota",374,240,-224,148,134,-76,14.492472827,9.2999825625,-8.679983725,5.7349892469,5.1924902641,-2.944994478
"1357","27085","McLeod County","Minnesota",426,310,-99,33,116,-66,11.899441341,8.6592178771,-2.765363128,0.9217877095,3.2402234637,-1.843575419
"1358","27087","Mahnomen County","Minnesota",108,63,-114,1,45,-113,19.744058501,11.517367459,-20.84095064,0.1828153565,8.226691042,-20.65813528
"1359","27089","Marshall County","Minnesota",116,87,-42,3,29,-39,12.321419088,9.2410643157,-4.461203463,0.3186573902,3.0803547719,-4.142546073
"1360","27091","Martin County","Minnesota",217,282,-151,8,-65,-143,10.77591558,14.003724395,-7.498448169,0.3972687772,-3.227808814,-7.101179392
"1361","27093","Meeker County","Minnesota",269,246,-133,18,23,-115,11.654607686,10.658117066,-5.762315324,0.7798622243,0.99649062,-4.9824531
"1362","27095","Mille Lacs County","Minnesota",312,304,-86,8,8,-78,12.225465802,11.91199232,-3.369839933,0.3134734821,0.3134734821,-3.056366451
"1363","27097","Morrison County","Minnesota",386,332,-105,7,54,-98,11.773676986,10.126582278,-3.202684154,0.213512277,1.6470947079,-2.989171877
"1364","27099","Mower County","Minnesota",531,374,-318,169,157,-149,13.471515736,9.4884122132,-8.06768739,4.2875445562,3.9831035226,-3.780142834
"1365","27101","Murray County","Minnesota",84,89,-47,11,-5,-36,9.9827678412,10.576980213,-5.585596292,1.3072672173,-0.594212372,-4.278329075
"1366","27103","Nicollet County","Minnesota",405,231,-73,61,174,-12,12.106899438,6.9054167165,-2.182231257,1.8235083104,5.2014827215,-0.358722946
"1367","27105","Nobles County","Minnesota",361,187,-281,197,174,-84,16.599227515,8.5984918153,-12.92072834,9.0583042119,8.0007356998,-3.862424131
"1368","27107","Norman County","Minnesota",65,82,42,9,-17,51,9.842519685,12.416717141,6.3597819503,1.3628104179,-2.574197456,7.7225923683
"1369","27109","Olmsted County","Minnesota",2229,990,-629,678,1239,49,14.791466207,6.5695610339,-4.173993829,4.4991539202,8.2219051727,0.3251600916
"1370","27111","Otter Tail County","Minnesota",653,689,31,69,-36,100,11.353362543,11.979275332,0.5389804576,1.1996661798,-0.625912789,1.7386466375
"1371","27113","Pennington County","Minnesota",192,125,43,15,67,58,13.547840813,8.8202088625,3.0341518487,1.0584250635,4.7276319503,4.0925769122
"1372","27115","Pine County","Minnesota",286,319,-4,2,-33,-2,9.8411988369,10.97672178,-0.137639145,0.0688195723,-1.135522943,-0.068819572
"1373","27117","Pipestone County","Minnesota",123,103,-85,11,20,-74,13.234344739,11.082418765,-9.145685388,1.1835592856,2.1519259737,-7.962126103
"1374","27119","Polk County","Minnesota",424,357,-125,76,67,-49,13.459890162,11.332973556,-3.968127996,2.4126218215,2.1269166058,-1.555506174
"1375","27121","Pope County","Minnesota",129,133,7,3,-4,10,11.804538799,12.17057101,0.640556369,0.2745241581,-0.366032211,0.9150805271
"1376","27123","Ramsey County","Minnesota",7789,4240,-3146,3608,3549,462,14.561722804,7.9267819602,-5.881522653,6.7452427624,6.6349408436,0.8637201098
"1377","27125","Red Lake County","Minnesota",51,26,9,2,25,11,12.702366127,6.4757160648,2.2415940224,0.498132005,6.2266500623,2.7397260274
"1378","27127","Redwood County","Minnesota",182,196,-98,4,-14,-94,11.759764805,12.664362097,-6.332181049,0.2584563693,-0.904597293,-6.073724679
"1379","27129","Renville County","Minnesota",166,190,-131,16,-24,-115,11.16942538,12.784282062,-8.814426053,1.076571121,-1.614856681,-7.737854932
"1380","27131","Rice County","Minnesota",698,501,-122,239,197,117,10.713408644,7.6897102161,-1.872544204,3.6683447937,3.0236984283,1.7958005894
"1381","27133","Rock County","Minnesota",100,103,73,-8,-3,65,10.630381631,10.94929308,7.7601785904,-0.85043053,-0.318911449,6.90974806
"1382","27135","Roseau County","Minnesota",182,138,-111,8,44,-103,11.630507716,8.8187366201,-7.093331629,0.5112311084,2.8117710963,-6.582100521
"1383","27137","St. Louis County","Minnesota",2064,2064,-506,162,0,-344,10.296241423,10.296241423,-2.524175465,0.808135228,0,-1.716040237
"1384","27139","Scott County","Minnesota",1838,653,732,274,1185,1006,13.103160656,4.6552578393,5.2184513604,1.9533547442,8.447902817,7.1718061046
"1385","27141","Sherburne County","Minnesota",1225,523,-246,73,702,-173,13.43909075,5.7376689486,-2.698788836,0.8008601018,7.7014218009,-1.897928734
"1386","27143","Sibley County","Minnesota",154,151,-63,24,3,-39,10.33141017,10.130148933,-4.226485979,1.6100898967,0.2012612371,-2.616396082
"1387","27145","Stearns County","Minnesota",2010,1039,260,708,971,968,12.973517243,6.7062111521,1.6781664096,4.569776223,6.2673060911,6.2479426325
"1388","27147","Steele County","Minnesota",492,311,-61,11,181,-50,13.462669823,8.5099396643,-1.669152153,0.3009946505,4.9527301583,-1.368157502
"1389","27149","Stevens County","Minnesota",121,93,-63,50,28,-13,12.276785714,9.4358766234,-6.392045455,5.0730519481,2.8409090909,-1.318993506
"1390","27151","Swift County","Minnesota",101,116,-111,16,-15,-95,10.705957176,12.295950816,-11.76595294,1.695993216,-1.58999364,-10.06995972
"1391","27153","Todd County","Minnesota",317,241,-101,8,76,-93,13.019282502,9.8979403249,-4.148099472,0.3285623344,3.1213421771,-3.819537138
"1392","27155","Traverse County","Minnesota",34,53,10,1,-19,11,10.07705987,15.708358032,2.9638411381,0.2963841138,-5.631298162,3.2602252519
"1393","27157","Wabasha County","Minnesota",225,208,-97,3,17,-94,10.504446883,9.7107775625,-4.528583767,0.1400592918,0.79366932,-4.388524475
"1394","27159","Wadena County","Minnesota",185,194,85,4,-9,89,13.573996625,14.234353217,6.236701152,0.2934918189,-0.660356593,6.5301929709
"1395","27161","Waseca County","Minnesota",208,167,-42,-1,41,-43,10.991043356,8.824539618,-2.219345293,-0.052841555,2.1665037385,-2.272186848
"1396","27163","Washington County","Minnesota",2852,1509,298,328,1343,626,11.430060016,6.047672007,1.1943050087,1.3145370565,5.3823880089,2.5088420652
"1397","27165","Watonwan County","Minnesota",162,116,-91,62,46,-29,14.735980352,10.551689635,-8.277618593,5.6396961841,4.1842907172,-2.637922409
"1398","27167","Wilkin County","Minnesota",68,72,-99,-3,-4,-102,10.612563402,11.236831838,-15.45064378,-0.468201327,-0.624268435,-15.9188451
"1399","27169","Winona County","Minnesota",472,451,-331,60,21,-271,9.2671673293,8.8548569185,-6.498797428,1.1780297453,0.4123104108,-5.320767683
"1400","27171","Wright County","Minnesota",1753,743,97,86,1010,183,13.444334091,5.6983115972,0.7439249326,0.6595623114,7.7460224941,1.403487244
"1401","27173","Yellow Medicine County","Minnesota",115,118,-145,3,-3,-142,11.6061967,11.908967048,-14.63390019,0.3027703487,-0.302770349,-14.33112984
"1402","28001","Adams County","Mississippi",411,405,-706,186,6,-520,12.915998869,12.727444141,-22.18660633,5.8451965683,0.188554728,-16.34140976
"1403","28003","Alcorn County","Mississippi",454,476,34,16,-22,50,12.184157911,12.77457966,0.9124699757,0.4293976356,-0.590421749,1.3418676113
"1404","28005","Amite County","Mississippi",125,169,-6,-1,-44,-7,9.9427298759,13.442570792,-0.477251034,-0.079541839,-3.499840916,-0.556792873
"1405","28007","Attala County","Mississippi",245,294,-105,3,-49,-102,13.067363593,15.680836311,-5.600298683,0.1600085338,-2.613472719,-5.440290149
"1406","28009","Benton County","Mississippi",96,107,-128,-1,-11,-129,11.669604327,13.00674649,-15.55947244,-0.121558378,-1.337142163,-15.68103082
"1407","28011","Bolivar County","Mississippi",481,396,-660,26,85,-634,14.33659707,11.803102785,-19.67183798,0.774951193,2.5334942847,-18.89688678
"1408","28013","Calhoun County","Mississippi",181,204,-48,10,-23,-38,12.337684469,13.905456528,-3.271872124,0.6816400259,-1.56777206,-2.590232098
"1409","28015","Carroll County","Mississippi",91,121,1,-2,-30,-1,8.9067240873,11.843006753,0.0978760889,-0.195752178,-2.936282666,-0.097876089
"1410","28017","Chickasaw County","Mississippi",281,193,-106,19,88,-87,16.148033216,11.090997902,-6.0914289,1.0918598971,5.057035313,-4.999569003
"1411","28019","Choctaw County","Mississippi",97,91,-24,3,6,-21,11.57794223,10.861780855,-2.8646455,0.3580806875,0.716161375,-2.506564813
"1412","28021","Claiborne County","Mississippi",111,111,30,16,0,46,12.077031879,12.077031879,3.26406267,1.740833424,0,5.004896094
"1413","28023","Clarke County","Mississippi",188,221,-224,6,-33,-218,11.6379844,13.680822087,-13.8665346,0.371425034,-2.042837687,-13.49510957
"1414","28025","Clay County","Mississippi",229,237,-136,10,-8,-126,11.409496288,11.808081311,-6.775945394,0.498231279,-0.398585023,-6.277714115
"1415","28027","Coahoma County","Mississippi",418,299,-458,0,119,-458,16.939536392,12.117036797,-18.56054466,0,4.8224995947,-18.56054466
"1416","28029","Copiah County","Mississippi",338,333,-148,32,5,-116,11.685595257,11.512731421,-5.116769521,1.106328545,0.1728638352,-4.010440976
"1417","28031","Covington County","Mississippi",264,264,87,3,0,90,13.753939931,13.753939931,4.5325483863,0.1562947719,0,4.6888431582
"1418","28033","DeSoto County","Mississippi",2126,1273,1553,93,853,1646,12.359099867,7.4003453107,9.0280724804,0.5406379528,4.9587545562,9.5687104331
"1419","28035","Forrest County","Mississippi",1075,724,-805,257,351,-548,14.182058047,9.5514511873,-10.62005277,3.3905013193,4.6306068602,-7.229551451
"1420","28037","Franklin County","Mississippi",85,122,-15,5,-37,-10,10.960670535,15.731785945,-1.934235977,0.6447453256,-4.771115409,-1.289490651
"1421","28039","George County","Mississippi",340,270,-36,28,70,-8,14.564770391,11.566141193,-1.542152159,1.1994516792,2.9986291981,-0.34270048
"1422","28041","Greene County","Mississippi",126,136,-806,0,-10,-806,9.0364686054,9.7536486535,-57.80471187,0,-0.717180048,-57.80471187
"1423","28043","Grenada County","Mississippi",273,286,-136,-3,-13,-139,12.6808649,13.28471561,-6.317207423,-0.139350164,-0.60385071,-6.456557586
"1424","28045","Hancock County","Mississippi",522,515,276,33,7,309,11.315233295,11.16349645,5.9827670298,0.7153308405,0.151736845,6.6980978703
"1425","28047","Harrison County","Mississippi",2748,1987,1027,552,761,1579,13.773918274,9.9595253311,5.1476761525,2.7668132777,3.8143929426,7.9144894302
"1426","28049","Hinds County","Mississippi",3293,2102,-2633,385,1191,-2248,13.454023235,8.5880221197,-10.75749869,1.5729726527,4.8660011154,-9.184526035
"1427","28051","Holmes County","Mississippi",277,237,-184,-2,40,-186,15.019248495,12.850403947,-9.976684921,-0.108442227,2.1688445481,-10.08512715
"1428","28053","Humphreys County","Mississippi",115,98,-112,5,17,-107,13.142857143,11.2,-12.8,0.5714285714,1.9428571429,-12.22857143
"1429","28055","Issaquena County","Mississippi",12,12,-52,0,0,-52,8.8105726872,8.8105726872,-38.17914831,0,0,-38.17914831
"1430","28057","Itawamba County","Mississippi",253,290,172,16,-37,188,10.778111487,12.354357041,7.3274117622,0.6816196988,-1.576245553,8.009031461
"1431","28059","Jackson County","Mississippi",1647,1413,-685,398,234,-287,11.646983947,9.9922212008,-4.844070433,2.8145109964,1.6547627466,-2.029559437
"1432","28061","Jasper County","Mississippi",224,211,9,-2,13,7,13.543335651,12.757338493,0.5441518788,-0.12092264,0.7859971583,0.4232292391
"1433","28063","Jefferson County","Mississippi",116,102,-94,0,14,-94,15.384615385,13.527851459,-12.4668435,0,1.8567639257,-12.4668435
"1434","28065","Jefferson Davis County","Mississippi",111,160,-134,0,-49,-134,9.4596897904,13.635588887,-11.41980569,0,-4.175899097,-11.41980569
"1435","28067","Jones County","Mississippi",1021,853,42,22,168,64,14.901302587,12.449374247,0.6129820849,0.321085854,2.4519283395,0.9340679388
"1436","28069","Kemper County","Mississippi",86,102,-96,0,-16,-96,8.4537501229,10.026540843,-9.436744323,0,-1.572790721,-9.436744323
"1437","28071","Lafayette County","Mississippi",572,388,451,74,184,525,10.918843595,7.4064883128,8.6090882193,1.4125776679,3.5123552824,10.021665887
"1438","28073","Lamar County","Mississippi",793,432,419,15,361,434,13.1106886,7.1422666777,6.9273373564,0.2479953708,5.9684219228,7.1753327271
"1439","28075","Lauderdale County","Mississippi",1052,900,-1144,52,152,-1092,13.35008439,11.421174858,-14.51758226,0.6598901029,1.9289095316,-13.85769216
"1440","28077","Lawrence County","Mississippi",156,144,59,0,12,59,12.344702065,11.395109599,4.6688296273,0,0.9495924666,4.6688296273
"1441","28079","Leake County","Mississippi",319,221,-499,-1,98,-500,13.882240306,9.6174768267,-21.71547935,-0.043517995,4.2647634797,-21.75899735
"1442","28081","Lee County","Mississippi",1183,966,-248,21,217,-227,13.958372664,11.39796111,-2.926184633,0.2477817633,2.5604115537,-2.67840287
"1443","28083","Leflore County","Mississippi",537,382,-622,5,155,-617,17.613198419,12.529314332,-20.40113485,0.1639962609,5.0838840874,-20.23713859
"1444","28085","Lincoln County","Mississippi",428,442,-203,4,-14,-199,12.358690787,12.762947028,-5.86171549,0.1155017831,-0.404256241,-5.746213707
"1445","28087","Lowndes County","Mississippi",792,610,-479,180,182,-299,13.254342806,10.208521605,-8.016199752,3.0123506376,3.0458212003,-5.003849115
"1446","28089","Madison County","Mississippi",1347,1006,1064,204,341,1268,13.249071729,9.8950008606,10.465487988,2.00654093,3.3540708683,12.472028918
"1447","28091","Marion County","Mississippi",303,343,-229,-2,-40,-231,11.860724561,13.42649678,-8.964045955,-0.078288611,-1.565772219,-9.042334566
"1448","28093","Marshall County","Mississippi",440,430,-293,2,10,-291,12.211198224,11.933670991,-8.131547908,0.0555054465,0.2775272324,-8.076042462
"1449","28095","Monroe County","Mississippi",410,428,-213,-2,-18,-215,11.406473869,11.907245893,-5.925802279,-0.055641336,-0.500772024,-5.981443614
"1450","28097","Montgomery County","Mississippi",124,152,-152,11,-28,-141,12.065190951,14.789588908,-14.78958891,1.0702991973,-2.724397957,-13.71928971
"1451","28099","Neshoba County","Mississippi",445,382,-38,-2,63,-40,15.108560952,12.969596143,-1.29016925,-0.067903645,2.1389648089,-1.358072895
"1452","28101","Newton County","Mississippi",257,268,-129,2,-11,-127,11.873960451,12.382184439,-5.960081316,0.0924043615,-0.508223988,-5.867676954
"1453","28103","Noxubee County","Mississippi",148,131,-156,10,17,-146,13.455768706,11.910173652,-14.18310756,0.9091735612,1.5455950541,-13.27393399
"1454","28105","Oktibbeha County","Mississippi",553,311,52,144,242,196,11.217379839,6.3085083725,1.0547988276,2.9209813686,4.9088714667,3.9757801962
"1455","28107","Panola County","Mississippi",477,411,-365,42,66,-323,13.89576718,11.973082413,-10.63302939,1.22352667,1.9226847671,-9.409502724
"1456","28109","Pearl River County","Mississippi",610,637,-121,-32,-27,-153,11.082748158,11.573296027,-2.198381192,-0.581390067,-0.490547869,-2.779771259
"1457","28111","Perry County","Mississippi",127,136,31,-1,-9,30,10.530679934,11.27694859,2.5704809287,-0.08291874,-0.746268657,2.4875621891
"1458","28113","Pike County","Mississippi",505,517,-41,27,-12,-14,12.643332833,12.943768464,-1.026488408,0.6759801712,-0.300435632,-0.350508237
"1459","28115","Pontotoc County","Mississippi",447,287,-99,2,160,-97,14.500746123,9.3103224551,-3.211574645,0.0648802959,5.1904236683,-3.146694349
"1460","28117","Prentiss County","Mississippi",307,316,43,2,-9,45,12.074967059,12.428956322,1.6912820311,0.0786642805,-0.353989262,1.7699463116
"1461","28119","Quitman County","Mississippi",107,86,-203,2,21,-201,14.074317659,11.312068399,-26.70174285,0.2630713581,2.7622492601,-26.43867149
"1462","28121","Rankin County","Mississippi",1834,1115,138,171,719,309,12.314758237,7.4868895499,0.9266284824,1.1482135543,4.8278686873,2.0748420367
"1463","28123","Scott County","Mississippi",460,270,-343,47,190,-296,16.140917225,9.4740166322,-12.03551002,1.649180673,6.666900593,-10.38632934
"1464","28125","Sharkey County","Mississippi",62,59,-51,3,3,-48,13.507625272,12.854030501,-11.11111111,0.6535947712,0.6535947712,-10.45751634
"1465","28127","Simpson County","Mississippi",292,328,-320,12,-36,-308,10.681493946,11.99839046,-11.70574679,0.4389655046,-1.316896514,-11.26678129
"1466","28129","Smith County","Mississippi",183,198,-117,-1,-15,-118,11.335129611,12.264238595,-7.247050079,-0.061940599,-0.929108984,-7.308990678
"1467","28131","Stone County","Mississippi",239,153,95,4,86,99,13.148122679,8.4169990373,5.2262412323,0.2200522624,4.7311236419,5.4462934947
"1468","28133","Sunflower County","Mississippi",330,281,-591,6,49,-585,12.157830748,10.352577092,-21.77356961,0.2210514682,1.8052536566,-21.55251814
"1469","28135","Tallahatchie County","Mississippi",165,161,-107,-3,4,-110,11.261261261,10.988260988,-7.302757303,-0.204750205,0.273000273,-7.507507508
"1470","28137","Tate County","Mississippi",326,308,186,13,18,199,11.494252874,10.859600874,6.5580706579,0.4583597772,0.6346519992,7.0164304351
"1471","28139","Tippah County","Mississippi",280,266,28,-5,14,23,12.734797835,12.098057943,1.2734797835,-0.227407104,0.6367398918,1.0460726793
"1472","28141","Tishomingo County","Mississippi",194,297,146,13,-103,159,9.9717296325,15.265998458,7.5044975585,0.6682086867,-5.294268825,8.1727062452
"1473","28143","Tunica County","Mississippi",192,100,-332,9,92,-323,18.495328003,9.6329833349,-31.98150467,0.8669685001,8.8623446681,-31.11453617
"1474","28145","Union County","Mississippi",346,318,79,34,28,113,12.262111493,11.269801892,2.7997306588,1.2049473722,0.9923096006,4.004678031
"1475","28147","Walthall County","Mississippi",179,189,-234,0,-10,-234,12.153308212,12.832263978,-15.88756493,0,-0.678955766,-15.88756493
"1476","28149","Warren County","Mississippi",637,573,-527,22,64,-505,13.347162418,12.006160229,-11.04231491,0.4609695027,1.3410021896,-10.5813454
"1477","28151","Washington County","Mississippi",748,584,-1255,28,164,-1227,15.426338204,12.044092929,-25.88242573,0.5774565103,3.3822452747,-25.30496922
"1478","28153","Wayne County","Mississippi",311,216,-52,-3,95,-55,15.191481047,10.550996483,-2.540054709,-0.146541618,4.6404845643,-2.686596327
"1479","28155","Webster County","Mississippi",91,137,-72,-1,-46,-73,9.1706137257,13.806308576,-7.255870201,-0.100775975,-4.63569485,-7.356646176
"1480","28157","Wilkinson County","Mississippi",110,127,-81,0,-17,-81,12.036986376,13.897247907,-8.863599059,0,-1.860261531,-8.863599059
"1481","28159","Winston County","Mississippi",189,194,-148,-1,-5,-149,10.203255324,10.473182714,-7.98985073,-0.053985478,-0.26992739,-8.043836208
"1482","28161","Yalobusha County","Mississippi",172,186,168,0,-14,168,13.887206814,15.017560857,13.564248516,0,-1.130354043,13.564248516
"1483","28163","Yazoo County","Mississippi",339,307,-452,23,32,-429,12.278160087,11.119159725,-16.37088012,0.8330315103,1.1590003622,-15.53784861
"1484","29001","Adair County","Missouri",274,230,-309,54,44,-255,10.782519725,9.0510202074,-12.15984889,2.1250221356,1.7314995179,-10.03482675
"1485","29003","Andrew County","Missouri",203,167,-1,1,36,0,11.73376492,9.6529002052,-0.057801798,0.0578017976,2.0808647149,0
"1486","29005","Atchison County","Missouri",50,84,-31,1,-34,-30,9.388789785,15.773166839,-5.821049667,0.1877757957,-6.384377054,-5.633273871
"1487","29007","Audrain County","Missouri",348,303,77,0,45,77,13.448755604,11.709692379,2.9757304066,0,1.7390632246,2.9757304066
"1488","29009","Barry County","Missouri",404,422,-37,46,-18,9,11.439250219,11.948919784,-1.047654104,1.3024888864,-0.509669564,0.2548347821
"1489","29011","Barton County","Missouri",135,152,-141,1,-17,-140,11.338344602,12.766136144,-11.84227103,0.0839877378,-1.427791542,-11.75828329
"1490","29013","Bates County","Missouri",187,213,-127,1,-26,-126,11.372620568,12.95384054,-7.723651402,0.0608161528,-1.581219972,-7.662835249
"1491","29015","Benton County","Missouri",170,310,52,1,-140,53,9.0271877655,16.461342396,2.7612574342,0.0531011045,-7.43415463,2.8143585387
"1492","29017","Bollinger County","Missouri",134,141,-92,0,-7,-92,10.83265966,11.398544867,-7.437348424,0,-0.565885206,-7.437348424
"1493","29019","Boone County","Missouri",2044,1116,-29,908,928,879,11.768092579,6.4252403708,-0.166964131,5.2277045311,5.342852208,5.0607403996
"1494","29021","Buchanan County","Missouri",1164,984,-904,282,180,-622,13.023630505,11.009667025,-10.11457214,3.1552094522,2.0139634801,-6.959362692
"1495","29023","Butler County","Missouri",528,629,77,-5,-101,72,12.326800285,14.684767764,1.7976583749,-0.116731063,-2.357967479,1.6809273116
"1496","29025","Caldwell County","Missouri",93,101,12,2,-8,14,10.325875756,11.214123133,1.3323710653,0.2220618442,-0.888247377,1.5544329096
"1497","29027","Callaway County","Missouri",516,398,-68,10,118,-58,11.554351355,8.9120772081,-1.522666458,0.2239215379,2.6422741471,-1.29874492
"1498","29029","Camden County","Missouri",419,478,227,22,-59,249,9.3847290971,10.706206464,5.0843281743,0.4927542724,-1.321477367,5.5770824467
"1499","29031","Cape Girardeau County","Missouri",908,792,39,179,116,218,11.630662423,10.144806871,0.4995548838,2.2928288256,1.4858555518,2.7923837094
"1500","29033","Carroll County","Missouri",94,113,-57,-1,-19,-58,10.539888995,12.670292089,-6.391209284,-0.112126479,-2.130403095,-6.503335763
"1501","29035","Carter County","Missouri",79,69,-14,-1,10,-15,12.581621277,10.989010989,-2.229654404,-0.159261029,1.5926102883,-2.388915432
"1502","29037","Cass County","Missouri",1154,909,235,49,245,284,11.415513822,8.9919428631,2.3246496951,0.4847141917,2.4235709587,2.8093638868
"1503","29039","Cedar County","Missouri",177,211,37,-3,-34,34,12.841906697,15.308713633,2.6844663716,-0.217659436,-2.466806936,2.4668069361
"1504","29041","Chariton County","Missouri",74,121,-47,1,-47,-46,9.684596257,15.835623609,-6.151027352,0.1308729224,-6.151027352,-6.02015443
"1505","29043","Christian County","Missouri",1068,667,834,8,401,842,12.954326296,8.0903891756,10.116018849,0.097036152,4.8639371206,10.213055001
"1506","29045","Clark County","Missouri",86,96,-75,5,-10,-70,12.560245363,14.02073901,-10.95370235,0.7302468234,-1.460493647,-10.22345553
"1507","29047","Clay County","Missouri",3108,1806,668,203,1302,871,13.275186762,7.7139598754,2.8532254689,0.8670730093,5.561226887,3.7202984781
"1508","29049","Clinton County","Missouri",237,261,342,-10,-24,332,11.610248371,12.785969725,16.754029295,-0.489883898,-1.175721354,16.264145398
"1509","29051","Cole County","Missouri",953,640,-222,105,313,-117,12.417747085,8.3393054922,-2.892696593,1.3681673073,4.0784415923,-1.524529285
"1510","29053","Cooper County","Missouri",195,201,42,12,-6,54,11.08931161,11.430521198,2.3884671159,0.682419176,-0.341209588,3.0708862919
"1511","29055","Crawford County","Missouri",299,288,-132,-5,11,-137,12.178481966,11.730444168,-5.376453577,-0.203653545,0.4480377981,-5.580107122
"1512","29057","Dade County","Missouri",75,115,14,5,-40,19,9.8840274117,15.155508698,1.8450184502,0.6589351608,-5.271481286,2.503953611
"1513","29059","Dallas County","Missouri",200,200,10,-4,0,6,12.241775057,12.241775057,0.6120887529,-0.244835501,0,0.3672532517
"1514","29061","Daviess County","Missouri",123,97,-68,2,26,-66,14.809463608,11.679007886,-8.187345735,0.2408042863,3.1304557221,-7.946541448
"1515","29063","DeKalb County","Missouri",107,117,18,-5,-10,13,8.5282748177,9.3253098474,1.4346630534,-0.398517515,-0.79703503,1.0361455386
"1516","29065","Dent County","Missouri",194,221,41,10,-27,51,12.428727016,14.158498302,2.6266897303,0.6406560318,-1.729771286,3.2673457621
"1517","29067","Douglas County","Missouri",162,157,-165,-4,5,-169,12.056262559,11.68415569,-12.27952668,-0.297685495,0.3721068691,-12.57721218
"1518","29069","Dunklin County","Missouri",430,463,-471,23,-33,-448,13.845509869,14.908072254,-15.16566314,0.7405737837,-1.062562385,-14.42508935
"1519","29071","Franklin County","Missouri",1228,982,80,20,246,100,12.026069542,9.6169383468,0.7834572991,0.1958643248,2.4091311948,0.9793216239
"1520","29073","Gasconade County","Missouri",151,216,3,1,-65,4,10.217545759,14.615827046,0.2029975979,0.067665866,-4.398281287,0.2706634638
"1521","29075","Gentry County","Missouri",106,83,-127,2,23,-125,15.805561768,12.376053083,-18.93685231,0.2982181466,3.4295086856,-18.63863416
"1522","29077","Greene County","Missouri",3601,2751,812,419,850,1231,12.578989838,9.6097753527,2.8364731321,1.4636480817,2.9692144856,4.3001212138
"1523","29079","Grundy County","Missouri",152,154,-173,20,-2,-153,15.04354711,15.241488519,-17.12193191,1.9794140934,-0.197941409,-15.14251781
"1524","29081","Harrison County","Missouri",115,115,-4,-2,0,-6,13.333333333,13.333333333,-0.463768116,-0.231884058,0,-0.695652174
"1525","29083","Henry County","Missouri",245,328,-237,-5,-83,-242,11.205122342,15.00114338,-10.8392408,-0.228675966,-3.796021038,-11.06791676
"1526","29085","Hickory County","Missouri",75,156,56,0,-81,56,8.0836387152,16.813968528,6.035783574,0,-8.730329812,6.035783574
"1527","29087","Holt County","Missouri",44,65,-26,0,-21,-26,9.7636746921,14.423610341,-5.769444136,0,-4.659935649,-5.769444136
"1528","29089","Howard County","Missouri",118,106,-9,5,12,-4,11.642821904,10.458806117,-0.88801184,0.4933399112,1.1840157869,-0.394671929
"1529","29091","Howell County","Missouri",480,550,5,19,-70,24,11.968731688,13.714171726,0.1246742884,0.473762296,-1.745440038,0.5984365844
"1530","29093","Iron County","Missouri",98,167,-94,0,-69,-94,9.5187217716,16.220678937,-9.130202516,0,-6.701957166,-9.130202516
"1531","29095","Jackson County","Missouri",9402,6223,-324,903,3179,579,13.728242991,9.0864556617,-0.473085591,1.3185070645,4.641787329,0.8454214733
"1532","29097","Jasper County","Missouri",1617,1154,221,131,463,352,13.687440482,9.768278489,1.8707015131,1.1088773675,3.9191619934,2.9795788805
"1533","29099","Jefferson County","Missouri",2523,1961,495,72,562,567,11.337516936,8.8120771742,2.2243642026,0.323543884,2.5254397613,2.5479080866
"1534","29101","Johnson County","Missouri",723,443,-1021,193,280,-828,13.447159915,8.2394078042,-18.98969609,3.5896291337,5.207752111,-15.40006696
"1535","29103","Knox County","Missouri",51,48,-89,0,3,-89,12.911392405,12.151898734,-22.53164557,0,0.7594936709,-22.53164557
"1536","29105","Laclede County","Missouri",474,416,-114,-3,58,-117,13.362275534,11.72722916,-3.213711837,-0.084571364,1.6350463733,-3.298283201
"1537","29107","Lafayette County","Missouri",399,400,-2,-3,-1,-5,12.234197495,12.264859644,-0.061324298,-0.091986447,-0.030662149,-0.153310746
"1538","29109","Lawrence County","Missouri",482,466,73,-13,16,60,12.705776911,12.284008383,1.9243189097,-0.342686929,0.4217685282,1.5816319806
"1539","29111","Lewis County","Missouri",105,134,71,2,-29,73,10.37600672,13.241760957,7.0161569247,0.1976382232,-2.865754237,7.213795148
"1540","29113","Lincoln County","Missouri",743,454,104,17,289,121,13.657586118,8.3452814235,1.911694423,0.3124885115,5.3123046947,2.2241829345
"1541","29115","Linn County","Missouri",157,180,-11,6,-23,-5,12.769937777,14.640692993,-0.894709016,0.4880230998,-1.870755216,-0.406685916
"1542","29117","Livingston County","Missouri",171,206,-44,4,-35,-40,11.421319797,13.759016831,-2.938819129,0.2671653754,-2.337697034,-2.671653754
"1543","29119","McDonald County","Missouri",315,232,-275,64,83,-211,13.833992095,10.188844971,-12.07729469,2.8107158542,3.6451471234,-9.266578832
"1544","29121","Macon County","Missouri",189,187,-174,2,2,-172,12.301884336,12.171705666,-11.32554431,0.1301786702,0.1301786702,-11.19536564
"1545","29123","Madison County","Missouri",140,176,23,-1,-36,22,11.484823626,14.438063987,1.8867924528,-0.082034454,-2.953240361,1.8047579984
"1546","29125","Maries County","Missouri",84,108,-44,0,-24,-44,9.3405982431,12.009340598,-4.892694318,0,-2.668742355,-4.892694318
"1547","29127","Marion County","Missouri",379,343,-115,17,36,-98,13.19063778,11.937701209,-4.002436266,0.5916644914,1.2529365701,-3.410771774
"1548","29129","Mercer County","Missouri",50,52,-20,1,-2,-19,13.618412093,14.163148577,-5.447364837,0.2723682419,-0.544736484,-5.174996595
"1549","29131","Miller County","Missouri",304,306,42,-3,-2,39,12.2311855,12.311653825,1.6898348388,-0.120702488,-0.080468326,1.5691323503
"1550","29133","Mississippi County","Missouri",139,139,-210,-2,0,-212,9.8914783846,9.8914783846,-14.94396015,-0.14232343,0,-15.08628358
"1551","29135","Moniteau County","Missouri",206,151,-14,14,55,0,13.009156931,9.5358383328,-0.884117461,0.8841174613,3.473318598,0
"1552","29137","Monroe County","Missouri",94,98,-97,0,-4,-97,10.825751468,11.286421744,-11.17125417,0,-0.460670275,-11.17125417
"1553","29139","Montgomery County","Missouri",129,148,-131,4,-19,-127,11.069160803,12.699502317,-11.2407757,0.3432297923,-1.630341514,-10.89754591
"1554","29141","Morgan County","Missouri",266,282,13,-2,-16,11,13.257906148,14.055374187,0.6479427817,-0.099683505,-0.797468039,0.5482592768
"1555","29143","New Madrid County","Missouri",228,261,-132,3,-33,-129,12.549537649,14.365918098,-7.265521797,0.1651254954,-1.816380449,-7.100396301
"1556","29145","Newton County","Missouri",733,651,-74,27,82,-47,12.606306593,11.196051285,-1.272669424,0.4643523574,1.4102553078,-0.808317067
"1557","29147","Nodaway County","Missouri",221,200,-403,8,21,-395,9.6959592857,8.774623788,-17.68086693,0.3509849515,0.9213354977,-17.32988198
"1558","29149","Oregon County","Missouri",142,147,36,-4,-5,32,13.105071293,13.566517466,3.3224124406,-0.369156938,-0.461446172,2.9532555027
"1559","29151","Osage County","Missouri",158,136,-120,1,22,-119,11.6480519,10.026171256,-8.846621696,0.0737218475,1.6218806443,-8.772899849
"1560","29153","Ozark County","Missouri",85,133,-26,-3,-48,-29,9.0536294403,14.166267242,-2.769345476,-0.319539863,-5.112637802,-3.088885338
"1561","29155","Pemiscot County","Missouri",270,236,-181,-6,34,-187,15.430334895,13.487255686,-10.34403932,-0.342896331,1.9430792091,-10.68693565
"1562","29157","Perry County","Missouri",215,206,-53,-1,9,-54,11.26067145,10.789294506,-2.775886451,-0.052375216,0.4713769444,-2.828261667
"1563","29159","Pettis County","Missouri",600,408,-141,76,192,-65,14.197655021,9.654405414,-3.33644893,1.7983696359,4.5432496066,-1.538079294
"1564","29161","Phelps County","Missouri",508,480,-435,251,28,-184,11.318568691,10.694710574,-9.692081458,5.5924424045,0.6238581168,-4.099639054
"1565","29163","Pike County","Missouri",216,216,-100,2,0,-98,11.70699981,11.70699981,-5.41990732,0.1083981464,0,-5.311509173
"1566","29165","Platte County","Missouri",1161,636,778,277,525,1055,12.138637671,6.6495896283,8.1342464321,2.8961263004,5.4890480422,11.030372733
"1567","29167","Polk County","Missouri",359,341,136,-5,18,131,11.50954587,10.932465576,4.3601622237,-0.160300082,0.5770802943,4.1998621419
"1568","29169","Pulaski County","Missouri",808,329,-1304,443,479,-861,15.145125163,6.1667650725,-24.44213269,8.3035772861,8.9783600903,-16.1385554
"1569","29171","Putnam County","Missouri",66,59,12,-2,7,10,13.608247423,12.164948454,2.4742268041,-0.412371134,1.4432989691,2.0618556701
"1570","29173","Ralls County","Missouri",91,106,-92,0,-15,-92,8.9084679393,10.376896721,-9.006363191,0,-1.468428781,-9.006363191
"1571","29175","Randolph County","Missouri",263,303,25,3,-40,28,10.504243635,12.101847229,0.9985022466,0.1198202696,-1.597603595,1.1183225162
"1572","29177","Ray County","Missouri",272,242,-169,-2,30,-171,11.907628324,10.594286965,-7.398489657,-0.087556091,1.3133413593,-7.486045748
"1573","29179","Reynolds County","Missouri",52,101,-57,0,-49,-57,8.1876869784,15.9030074,-8.974964573,0,-7.715320422,-8.974964573
"1574","29181","Ripley County","Missouri",187,171,-159,-1,16,-160,13.492550236,12.338107435,-11.47227533,-0.072152675,1.154442801,-11.54442801
"1575","29183","St. Charles County","Missouri",4475,2754,2854,619,1721,3473,11.700921823,7.2009695423,7.4624426557,1.6185185718,4.4999522812,9.0809612275
"1576","29185","St. Clair County","Missouri",96,157,44,-3,-61,41,10.18837888,16.662244627,4.6696736535,-0.31838684,-6.473865747,4.3512868135
"1577","29186","Ste. Genevieve County","Missouri",194,217,-109,5,-23,-104,10.849808451,12.136125947,-6.096026397,0.2796342384,-1.286317497,-5.816392159
"1578","29187","St. Francois County","Missouri",718,793,525,-7,-75,518,10.877716589,12.013968321,7.9537621295,-0.106050162,-1.136251733,7.8477119678
"1579","29189","St. Louis County","Missouri",11839,10074,-3739,2653,1765,-1086,11.828348572,10.064936525,-3.73563606,2.6506131229,1.7634120475,-1.085022937
"1580","29195","Saline County","Missouri",269,246,-268,57,23,-211,11.542587428,10.555674748,-11.49967818,2.4458270757,0.9869126797,-9.053851105
"1581","29197","Schuyler County","Missouri",64,49,89,5,15,94,14.390106802,11.01742552,20.011242271,1.1242270939,3.3726812816,21.135469365
"1582","29199","Scotland County","Missouri",61,67,-12,0,-6,-12,12.629399586,13.871635611,-2.48447205,0,-1.242236025,-2.48447205
"1583","29201","Scott County","Missouri",504,440,73,10,64,83,12.946646459,11.302627861,1.8752087133,0.2568779059,1.644018598,2.1320866192
"1584","29203","Shannon County","Missouri",89,90,-18,0,-1,-18,10.739712803,10.860383734,-2.172076747,0,-0.12067093,-2.172076747
"1585","29205","Shelby County","Missouri",75,92,26,2,-17,28,12.300123001,15.088150882,4.2640426404,0.32800328,-2.78802788,4.5920459205
"1586","29207","Stoddard County","Missouri",364,420,11,-4,-56,7,12.231182796,14.112903226,0.3696236559,-0.134408602,-1.88172043,0.2352150538
"1587","29209","Stone County","Missouri",230,405,34,8,-175,42,7.3309109454,12.908777969,1.0836998789,0.2549882068,-5.577867024,1.3386880857
"1588","29211","Sullivan County","Missouri",85,74,-139,17,11,-122,13.244001246,11.530071673,-21.65783733,2.6488002493,1.7139295731,-19.00903708
"1589","29213","Taney County","Missouri",660,574,296,11,86,307,12.218036413,10.625989244,5.4796042097,0.2036339402,1.592047169,5.6832381499
"1590","29215","Texas County","Missouri",290,317,42,-7,-27,35,11.306042885,12.358674464,1.6374269006,-0.272904483,-1.052631579,1.3645224172
"1591","29217","Vernon County","Missouri",261,263,-228,7,-2,-221,12.50658872,12.602424649,-10.92529589,0.3354257511,-0.095835929,-10.58987014
"1592","29219","Warren County","Missouri",419,296,209,8,123,217,12.575030012,8.8835534214,6.2725090036,0.2400960384,3.6914765906,6.512605042
"1593","29221","Washington County","Missouri",297,292,-291,-1,5,-292,11.914074252,11.713500612,-11.67338588,-0.040114728,0.2005736406,-11.71350061
"1594","29223","Wayne County","Missouri",146,199,8,0,-53,8,10.860267044,14.802692751,0.5950831257,0,-3.942425708,0.5950831257
"1595","29225","Webster County","Missouri",567,348,338,3,219,341,15.216370346,9.3391479369,9.0707816169,0.080509896,5.8772224086,9.1512915129
"1596","29227","Worth County","Missouri",27,33,-6,0,-6,-6,13.18359375,16.11328125,-2.9296875,0,-2.9296875,-2.9296875
"1597","29229","Wright County","Missouri",255,233,-68,-4,22,-72,13.976431899,12.770622088,-3.727048506,-0.219238147,1.2058098109,-3.946286654
"1598","29510","St. Louis city","Missouri",4574,3011,-3971,901,1563,-3070,14.445586659,9.5093269411,-12.54119471,2.8455342325,4.9362597174,-9.695660481
"1599","30001","Beaverhead County","Montana",87,98,-40,13,-11,-27,9.3372685806,10.517842769,-4.292997049,1.3952240408,-1.180574188,-2.897773008
"1600","30003","Big Horn County","Montana",292,131,-216,20,161,-196,21.912051628,9.8304067237,-16.2089149,1.500825454,12.081644905,-14.70808945
"1601","30005","Blaine County","Montana",120,81,-81,10,39,-71,17.938560431,12.108528291,-12.10852829,1.4948800359,5.8300321399,-10.61364825
"1602","30007","Broadwater County","Montana",43,47,64,1,-4,65,7.567091949,8.2710074791,11.262648482,0.1759788825,-0.70391553,11.438627365
"1603","30009","Carbon County","Montana",58,96,2,2,-38,4,5.5659517298,9.2126097596,0.19192937,0.19192937,-3.64665803,0.38385874
"1604","30011","Carter County","Montana",19,10,-13,0,9,-13,16.54331737,8.7070091424,-11.31911189,0,7.8363082281,-11.31911189
"1605","30013","Cascade County","Montana",1200,827,-650,108,373,-542,14.639055781,10.088749276,-7.929488548,1.3175150203,4.5503065052,-6.611973528
"1606","30015","Chouteau County","Montana",55,67,-115,2,-12,-113,9.4266860914,11.483417602,-19.71034365,0.3427885851,-2.056731511,-19.36755506
"1607","30017","Custer County","Montana",164,137,44,-2,27,42,13.620131218,11.377792542,3.6541815464,-0.166099161,2.2423386762,3.4880823852
"1608","30019","Daniels County","Montana",20,29,-41,4,-9,-37,11.270780502,16.342631727,-23.10510003,2.2541561003,-5.071851226,-20.85094393
"1609","30021","Dawson County","Montana",133,94,35,-9,39,26,13.942761296,9.8542824195,3.6691477094,-0.943495125,4.0884788762,2.7256525841
"1610","30023","Deer Lodge County","Montana",83,132,42,-3,-49,39,9.111367254,14.490367199,4.6105713815,-0.329326527,-5.378999945,4.2812448543
"1611","30025","Fallon County","Montana",52,29,38,0,23,38,16.55787295,9.2341983761,12.099984079,0,7.3236745741,12.099984079
"1612","30027","Fergus County","Montana",149,150,-24,2,-1,-22,13.165451734,13.253810471,-2.120609675,0.1767174729,-0.088358736,-1.943892202
"1613","30029","Flathead County","Montana",1107,933,1117,-24,174,1093,11.626380436,9.7989276843,11.731406456,-0.252062448,1.8274527514,11.479344007
"1614","30031","Gallatin County","Montana",1120,533,2601,118,587,2719,11.291802353,5.3736880841,26.223194572,1.1896720336,5.918114269,27.412866606
"1615","30033","Garfield County","Montana",18,21,12,0,-3,12,14.067995311,16.412661196,9.3786635404,0,-2.344665885,9.3786635404
"1616","30035","Glacier County","Montana",250,125,-197,6,125,-191,18.278194114,9.1390970572,-14.40321696,0.4386766587,9.1390970572,-13.9645403
"1617","30037","Golden Valley County","Montana",8,9,-23,0,-1,-23,9.6443640747,10.849909584,-27.72754671,0,-1.205545509,-27.72754671
"1618","30039","Granite County","Montana",26,33,25,2,-7,27,8.2265464325,10.441385857,7.9101408005,0.632811264,-2.214839424,8.5429520645
"1619","30041","Hill County","Montana",316,163,-223,1,153,-222,19.18290536,9.8949796637,-13.53730347,0.0607053967,9.2879256966,-13.47659807
"1620","30043","Jefferson County","Montana",83,114,99,3,-31,102,7.1936210782,9.8803952158,8.5803432137,0.2600104004,-2.686774138,8.8403536141
"1621","30045","Judith Basin County","Montana",11,14,-52,1,-3,-51,5.619412516,7.1519795658,-26.56449553,0.5108556833,-1.53256705,-26.05363985
"1622","30047","Lake County","Montana",377,302,171,-2,75,169,12.852637859,10.295747038,5.8297110713,-0.068183755,2.5568908208,5.7615273161
"1623","30049","Lewis and Clark County","Montana",778,595,357,-15,183,342,11.793954461,9.0197980778,5.4118788467,-0.227389868,2.7741563836,5.1844889792
"1624","30051","Liberty County","Montana",22,24,45,0,-2,45,9.2827004219,10.126582278,18.987341772,0,-0.843881857,18.987341772
"1625","30053","Lincoln County","Montana",169,263,-40,6,-94,-34,8.839836803,13.756669108,-2.092269066,0.3138403599,-4.916832305,-1.778428706
"1626","30055","McCone County","Montana",21,15,-21,0,6,-21,12.305889247,8.7899208907,-12.30588925,0,3.5159683563,-12.30588925
"1627","30057","Madison County","Montana",57,56,133,70,1,203,7.1869877695,7.0609002648,16.769638129,8.826125331,0.1260875047,25.59576346
"1628","30059","Meagher County","Montana",17,31,-22,1,-14,-21,9.2441544318,16.856987493,-11.96302338,0.5437737901,-7.612833061,-11.41924959
"1629","30061","Mineral County","Montana",43,54,8,-2,-11,6,10.266205085,12.892443596,1.9099916438,-0.477497911,-2.62623851,1.4324937328
"1630","30063","Missoula County","Montana",1245,864,848,87,381,935,10.973658812,7.6154547898,7.4744278493,0.7668339893,3.3582040219,8.2412618386
"1631","30065","Musselshell County","Montana",46,47,-22,7,-1,-15,9.9191374663,10.134770889,-4.74393531,1.5094339623,-0.215633423,-3.234501348
"1632","30067","Park County","Montana",139,167,90,21,-28,111,8.7062729009,10.460054492,5.6371551157,1.3153361937,-1.753781592,6.9524913094
"1633","30069","Petroleum County","Montana",3,3,-14,0,0,-14,6.237006237,6.237006237,-29.10602911,0,0,-29.10602911
"1634","30071","Phillips County","Montana",63,48,-40,-1,15,-41,15.151515152,11.544011544,-9.62000962,-0.240500241,3.6075036075,-9.860509861
"1635","30073","Pondera County","Montana",84,62,-72,9,22,-63,13.732221677,10.135687428,-11.77047572,1.4713094654,3.5965342488,-10.29916626
"1636","30075","Powder River County","Montana",17,20,-6,0,-3,-6,9.5909732017,11.283497884,-3.385049365,0,-1.692524683,-3.385049365
"1637","30077","Powell County","Montana",55,76,-63,1,-21,-62,8.039172696,11.108674998,-9.208506906,0.1461667763,-3.069502302,-9.06234013
"1638","30079","Prairie County","Montana",16,16,15,2,0,17,14.11557124,14.11557124,13.233348037,1.7644464049,0,14.997794442
"1639","30081","Ravalli County","Montana",395,412,437,-22,-17,415,9.6475588013,10.062770193,10.67337518,-0.537332389,-0.415211391,10.136042791
"1640","30083","Richland County","Montana",177,83,281,-6,94,275,15.105611265,7.0834222317,23.981224664,-0.512054619,8.0221890335,23.469170045
"1641","30085","Roosevelt County","Montana",256,174,46,3,82,49,22.555066079,15.330396476,4.0528634361,0.2643171806,7.2246696035,4.3171806167
"1642","30087","Rosebud County","Montana",148,90,-39,7,58,-32,15.844976179,9.6354584872,-4.175365344,0.749424549,6.2095176918,-3.425940795
"1643","30089","Sanders County","Montana",127,147,6,-3,-20,3,11.235955056,13.005396797,0.5308325223,-0.265416261,-1.769441741,0.2654162612
"1644","30091","Sheridan County","Montana",51,54,1,13,-3,14,13.913517938,14.731960169,0.2728140772,3.5465830037,-0.818442232,3.8193970809
"1645","30093","Silver Bow County","Montana",405,398,-160,88,7,-72,11.663234892,11.461648116,-4.607697735,2.5342337543,0.2015867759,-2.073463981
"1646","30095","Stillwater County","Montana",87,96,184,16,-9,200,9.3147751606,10.278372591,19.700214133,1.7130620985,-0.96359743,21.413276231
"1647","30097","Sweet Grass County","Montana",31,40,-11,1,-9,-10,8.5399449036,11.019283747,-3.03030303,0.2754820937,-2.479338843,-2.754820937
"1648","30099","Teton County","Montana",78,67,19,8,11,27,12.893627573,11.075295479,3.1407554343,1.3224233408,1.8183320936,4.4631787751
"1649","30101","Toole County","Montana",58,48,-44,-3,10,-47,11.377010592,9.415457042,-8.630835622,-0.588466065,1.9615535504,-9.219301687
"1650","30103","Treasure County","Montana",8,8,-4,0,0,-4,11.653313911,11.653313911,-5.826656956,0,0,-5.826656956
"1651","30105","Valley County","Montana",83,77,-16,5,6,-11,10.884532162,10.097698512,-2.098223067,0.6556947085,0.7868336503,-1.442528359
"1652","30107","Wheatland County","Montana",24,21,0,19,3,19,11.428571429,10,0,9.0476190476,1.4285714286,9.0476190476
"1653","30109","Wibaux County","Montana",17,22,-9,0,-5,-9,15.784586815,20.427112349,-8.356545961,0,-4.642525534,-8.356545961
"1654","30111","Yellowstone County","Montana",2067,1433,608,30,634,638,13.258116347,9.1915242985,3.8998232893,0.1924254912,4.0665920483,4.0922487805
"1655","31001","Adams County","Nebraska",410,334,62,39,76,101,13.023108076,10.60906853,1.9693480505,1.2387834511,2.4140395458,3.2081315016
"1656","31003","Antelope County","Nebraska",79,76,-10,3,3,-7,12.312967581,11.845386534,-1.558603491,0.4675810474,0.4675810474,-1.091022444
"1657","31005","Arthur County","Nebraska",3,6,2,0,-3,2,6.6518847007,13.303769401,4.4345898004,0,-6.651884701,4.4345898004
"1658","31007","Banner County","Nebraska",4,6,44,2,-2,46,5.7845263919,8.6767895879,63.629790311,2.892263196,-2.892263196,66.522053507
"1659","31009","Blaine County","Nebraska",6,5,-15,0,1,-15,12.409513961,10.341261634,-31.0237849,0,2.0682523268,-31.0237849
"1660","31011","Boone County","Nebraska",68,73,-41,1,-5,-40,12.749601575,13.687072279,-7.687259773,0.1874941408,-0.937470704,-7.499765632
"1661","31013","Box Butte County","Nebraska",184,111,-54,9,73,-45,16.264474498,9.8117210289,-4.77326969,0.7955449483,6.4527534695,-3.977724741
"1662","31015","Boyd County","Nebraska",16,36,1,0,-20,1,7.9621796467,17.914904205,0.4976362279,0,-9.952724558,0.4976362279
"1663","31017","Brown County","Nebraska",25,46,30,0,-21,30,8.3948959033,15.446608462,10.073875084,0,-7.051712559,10.073875084
"1664","31019","Buffalo County","Nebraska",723,371,-28,91,352,63,14.934930799,7.6637058459,-0.578392894,1.8797769056,7.2712249535,1.3013840116
"1665","31021","Burt County","Nebraska",76,92,7,1,-16,8,11.622572259,14.069429576,1.0705000765,0.1529285824,-2.446857318,1.2234286588
"1666","31023","Butler County","Nebraska",83,106,-102,2,-23,-100,10.225452753,13.05901195,-12.56621905,0.2463964519,-2.833559197,-12.31982259
"1667","31025","Cass County","Nebraska",299,260,-25,-2,39,-27,11.767715528,10.232796112,-0.983922703,-0.078713816,1.5349194167,-1.062636519
"1668","31027","Cedar County","Nebraska",132,121,-38,-1,11,-39,15.478424015,14.188555347,-4.455909944,-0.117260788,1.2898686679,-4.573170732
"1669","31029","Chase County","Nebraska",49,61,-15,8,-12,-7,12.34256927,15.365239295,-3.778337531,2.0151133501,-3.022670025,-1.763224181
"1670","31031","Cherry County","Nebraska",89,75,63,-1,14,62,15.399255991,12.976901116,10.900596937,-0.173025348,2.422354875,10.727571589
"1671","31033","Cheyenne County","Nebraska",117,90,0,-4,27,-4,11.556696958,8.8897668906,0,-0.395100751,2.6669300672,-0.395100751
"1672","31035","Clay County","Nebraska",95,80,-36,1,15,-35,15.072187847,12.692368713,-5.711565921,0.1586546089,2.3798191337,-5.552911312
"1673","31037","Colfax County","Nebraska",191,82,-179,136,109,-43,17.85046729,7.6635514019,-16.72897196,12.710280374,10.186915888,-4.018691589
"1674","31039","Cuming County","Nebraska",129,96,26,0,33,26,14.258082343,10.61066593,2.8737220227,0,3.6474164134,2.8737220227
"1675","31041","Custer County","Nebraska",136,124,48,-2,12,46,12.590843864,11.479887053,4.4438272462,-0.185159469,1.1109568116,4.2586677776
"1676","31043","Dakota County","Nebraska",373,149,-241,15,224,-226,18.137171477,7.2451435657,-11.71865503,0.729376869,10.892027911,-10.98927816
"1677","31045","Dawes County","Nebraska",87,72,-85,8,15,-77,9.6817271311,8.0124638326,-9.459158691,0.8902737592,1.6692632985,-8.568884932
"1678","31047","Dawson County","Nebraska",423,210,-418,106,213,-312,17.661426693,8.7680841736,-17.45266278,4.4257948686,8.8933425189,-13.02686792
"1679","31049","Deuel County","Nebraska",17,22,-10,1,-5,-9,8.8633993743,11.470281543,-5.213764338,0.5213764338,-2.606882169,-4.692387904
"1680","31051","Dixon County","Nebraska",83,67,-12,4,16,-8,14.407220969,11.62992536,-2.082971706,0.6943239021,2.7772956084,-1.388647804
"1681","31053","Dodge County","Nebraska",510,474,-157,68,36,-89,13.938996392,12.955067235,-4.29102438,1.8585328523,0.9839291571,-2.432491527
"1682","31055","Douglas County","Nebraska",8757,4151,-70,1492,4606,1422,16.036258756,7.6015199377,-0.12818752,2.7322254269,8.4347388179,2.6040379069
"1683","31057","Dundy County","Nebraska",14,21,-85,-2,-7,-87,7.6965365585,11.544804838,-46.72897196,-1.099505223,-3.848268279,-47.82847719
"1684","31059","Fillmore County","Nebraska",61,100,-10,0,-39,-10,10.934839114,17.925965761,-1.792596576,0,-6.991126647,-1.792596576
"1685","31061","Franklin County","Nebraska",24,40,-54,0,-16,-54,7.9668049793,13.278008299,-17.9253112,0,-5.31120332,-17.9253112
"1686","31063","Frontier County","Nebraska",22,18,-98,2,4,-96,8.2181546507,6.7239447142,-36.60814344,0.7471049682,1.4942099365,-35.86103848
"1687","31065","Furnas County","Nebraska",57,73,-6,0,-16,-6,11.774426771,15.079529023,-1.239413344,0,-3.305102252,-1.239413344
"1688","31067","Gage County","Nebraska",227,275,203,-4,-48,199,10.49444072,12.713529507,9.3848963269,-0.184924066,-2.219088787,9.1999722614
"1689","31069","Garden County","Nebraska",26,30,13,0,-4,13,13.59832636,15.690376569,6.7991631799,0,-2.092050209,6.7991631799
"1690","31071","Garfield County","Nebraska",24,27,18,0,-3,18,11.958146487,13.452914798,8.9686098655,0,-1.494768311,8.9686098655
"1691","31073","Gosper County","Nebraska",21,18,19,0,3,19,10.424422934,8.9352196575,9.4316207496,0,1.4892032762,9.4316207496
"1692","31075","Grant County","Nebraska",10,6,16,0,4,16,15.72327044,9.4339622642,25.157232704,0,6.2893081761,25.157232704
"1693","31077","Greeley County","Nebraska",32,29,-54,1,3,-53,13.013420089,11.793411956,-21.9601464,0.4066693778,1.2200081334,-21.55347702
"1694","31079","Hall County","Nebraska",1011,557,-707,291,454,-416,16.539471424,9.1122508241,-11.56617834,4.7606193713,7.4272205999,-6.805558964
"1695","31081","Hamilton County","Nebraska",92,91,38,0,1,38,10.08661331,9.9769762087,4.1662098454,0,0.1096371012,4.1662098454
"1696","31083","Harlan County","Nebraska",43,36,-34,1,7,-33,12.445730825,10.419681621,-9.84081042,0.2894356006,2.0260492041,-9.551374819
"1697","31085","Hayes County","Nebraska",12,5,-3,0,7,-3,13.150684932,5.4794520548,-3.287671233,0,7.6712328767,-3.287671233
"1698","31087","Hitchcock County","Nebraska",47,36,-9,0,11,-9,16.305290546,12.489158716,-3.122289679,0,3.81613183,-3.122289679
"1699","31089","Holt County","Nebraska",143,149,-93,5,-6,-88,13.863977895,14.445683261,-9.016433177,0.4847544719,-0.581705366,-8.531678705
"1700","31091","Hooker County","Nebraska",6,16,2,0,-10,2,8.356545961,22.284122563,2.7855153203,0,-13.9275766,2.7855153203
"1701","31093","Howard County","Nebraska",81,49,-3,1,32,-2,12.721847024,7.6959321501,-0.471179519,0.1570598398,5.0259148736,-0.31411968
"1702","31095","Jefferson County","Nebraska",60,101,-51,5,-41,-46,8.2690187431,13.919514884,-7.028665932,0.6890848953,-5.650496141,-6.339581036
"1703","31097","Johnson County","Nebraska",47,60,29,3,-13,32,8.9857566198,11.471178664,5.5444030207,0.5735589332,-2.485422044,6.1179619539
"1704","31099","Kearney County","Nebraska",81,80,-32,0,1,-32,12.325952979,12.17378072,-4.869512288,0,0.152172259,-4.869512288
"1705","31101","Keith County","Nebraska",78,98,-12,-5,-20,-17,9.5693779904,12.023064655,-1.472211999,-0.613421666,-2.453686664,-2.085633665
"1706","31103","Keya Paha County","Nebraska",10,6,-2,0,4,-2,12.56281407,7.5376884422,-2.512562814,0,5.0251256281,-2.512562814
"1707","31105","Kimball County","Nebraska",44,39,-22,8,5,-14,11.824778285,10.48105348,-5.912389143,2.1499596883,1.3437248052,-3.762429454
"1708","31107","Knox County","Nebraska",95,113,14,0,-18,14,11.215394605,13.34041674,1.6527949944,0,-2.125022136,1.6527949944
"1709","31109","Lancaster County","Nebraska",4084,2144,537,1046,1940,1583,13.41699793,7.0435953875,1.7641841059,3.4363809586,6.3734025428,5.2005650646
"1710","31111","Lincoln County","Nebraska",419,391,-184,15,28,-169,11.775616885,10.988702153,-5.171153954,0.4215614637,0.7869147322,-4.749592491
"1711","31113","Logan County","Nebraska",9,7,20,1,2,21,11.560693642,8.9916506101,25.690430315,1.2845215157,2.5690430315,26.97495183
"1712","31115","Loup County","Nebraska",8,8,10,0,0,10,13.311148087,13.311148087,16.638935108,0,0,16.638935108
"1713","31117","McPherson County","Nebraska",3,4,-22,0,-1,-22,6.006006006,8.008008008,-44.04404404,0,-2.002002002,-44.04404404
"1714","31119","Madison County","Nebraska",542,374,-354,105,168,-249,15.458992313,10.667275139,-10.09683262,2.9948232341,4.7917171746,-7.102009384
"1715","31121","Merrick County","Nebraska",100,90,7,0,10,7,12.832852101,11.549566891,0.8982996471,0,1.2832852101,0.8982996471
"1716","31123","Morrill County","Nebraska",59,69,15,1,-10,16,11.986997156,14.018691589,3.0475416497,0.2031694433,-2.031694433,3.2507110931
"1717","31125","Nance County","Nebraska",39,46,51,3,-7,54,10.985915493,12.957746479,14.366197183,0.8450704225,-1.971830986,15.211267606
"1718","31127","Nemaha County","Nebraska",69,76,-123,2,-7,-121,9.7657632156,10.756492817,-17.40853443,0.2830656005,-0.990729602,-17.12546883
"1719","31129","Nuckolls County","Nebraska",51,53,-31,2,-2,-29,11.774212167,12.235945977,-7.156874062,0.4617338105,-0.46173381,-6.695140252
"1720","31131","Otoe County","Nebraska",218,208,29,25,10,54,13.788741303,13.156230234,1.8342820999,1.5812776724,0.6325110689,3.4155597723
"1721","31133","Pawnee County","Nebraska",34,32,-37,0,2,-37,12.557710065,11.819021237,-13.66574331,0,0.7386888273,-13.66574331
"1722","31135","Perkins County","Nebraska",43,44,56,2,-1,58,14.789337919,15.13327601,19.260533104,0.6878761823,-0.343938091,19.948409286
"1723","31137","Phelps County","Nebraska",120,114,47,1,6,48,13.060513714,12.407488028,5.1153678711,0.1088376143,0.6530256857,5.2242054854
"1724","31139","Pierce County","Nebraska",94,95,-13,1,-1,-12,13.063720381,13.20269613,-1.806684734,0.1389757487,-0.138975749,-1.667708985
"1725","31141","Platte County","Nebraska",509,277,-181,86,232,-95,15.508363548,8.4397184729,-5.51476189,2.6202736053,7.0686450748,-2.894488285
"1726","31143","Polk County","Nebraska",40,58,-84,8,-18,-76,7.6547698785,11.099416324,-16.07501674,1.5309539757,-3.444646445,-14.54406277
"1727","31145","Red Willow County","Nebraska",119,125,-16,9,-6,-7,10.924446892,11.475259341,-1.468833196,0.8262186725,-0.550812448,-0.642614523
"1728","31147","Richardson County","Nebraska",90,134,-42,-1,-44,-43,11.15933044,16.6150031,-5.207687539,-0.12399256,-5.45567266,-5.331680099
"1729","31149","Rock County","Nebraska",12,34,-11,0,-22,-11,8.3740404745,23.726448011,-7.676203768,0,-15.35240754,-7.676203768
"1730","31151","Saline County","Nebraska",190,140,-211,59,50,-152,13.330059284,9.8221489459,-14.80338163,4.1393341986,3.5079103378,-10.66404743
"1731","31153","Sarpy County","Nebraska",2577,922,1347,374,1655,1721,14.848019544,5.3123298484,7.7610719152,2.1548930188,9.5356896954,9.915964934
"1732","31155","Saunders County","Nebraska",246,203,44,6,43,50,11.769208688,9.7119892833,2.1050617166,0.2870538704,2.0572194048,2.392115587
"1733","31157","Scotts Bluff County","Nebraska",475,396,-305,22,79,-283,13.073694351,10.899332553,-8.394687952,0.6055184752,2.1743617973,-7.789169476
"1734","31159","Seward County","Nebraska",206,192,-44,19,14,-25,12.116577949,11.293121195,-2.588006941,1.1175484516,0.8234567538,-1.470458489
"1735","31161","Sheridan County","Nebraska",51,82,-7,0,-31,-7,9.7430509122,15.665297545,-1.337281498,0,-5.922246633,-1.337281498
"1736","31163","Sherman County","Nebraska",25,45,24,0,-20,24,8.23723229,14.827018122,7.9077429984,0,-6.589785832,7.9077429984
"1737","31165","Sioux County","Nebraska",8,11,-43,0,-3,-43,6.160954948,8.4713130535,-33.11513285,0,-2.310358106,-33.11513285
"1738","31167","Stanton County","Nebraska",73,47,-186,1,26,-185,12.126245847,7.8073089701,-30.89700997,0.1661129568,4.3189368771,-30.73089701
"1739","31169","Thayer County","Nebraska",52,77,-61,0,-25,-61,10.059972915,14.896498356,-11.80112207,0,-4.83652544,-11.80112207
"1740","31171","Thomas County","Nebraska",5,4,-9,3,1,-6,7.1633237822,5.7306590258,-12.89398281,4.2979942693,1.4326647564,-8.595988539
"1741","31173","Thurston County","Nebraska",166,76,16,4,90,20,23.658519205,10.831611202,2.2803392005,0.5700848001,12.826908003,2.8504240006
"1742","31175","Valley County","Nebraska",53,48,-64,8,5,-56,12.641621944,11.4490161,-15.2653548,1.90816935,1.1926058438,-13.35718545
"1743","31177","Washington County","Nebraska",224,190,-61,18,34,-43,11.241875988,9.5355198113,-3.061403729,0.9033650348,1.7063561768,-2.158038694
"1744","31179","Wayne County","Nebraska",97,61,-74,6,36,-68,10.331238684,6.496964533,-7.881563532,0.6390456918,3.8342741506,-7.24251784
"1745","31181","Webster County","Nebraska",34,69,-20,0,-35,-20,9.3961586293,19.068674865,-5.527152135,0,-9.672516236,-5.527152135
"1746","31183","Wheeler County","Nebraska",7,2,-13,0,5,-13,8.945686901,2.5559105431,-16.61341853,0,6.3897763578,-16.61341853
"1747","31185","York County","Nebraska",176,160,-142,3,16,-139,12.701161868,11.546510789,-10.24752833,0.2164970773,1.1546510789,-10.03103125
"1748","32001","Churchill County","Nevada",319,265,9,55,54,64,13.360417147,11.098779134,0.3769396687,2.3035201977,2.2616380123,2.6804598664
"1749","32003","Clark County","Nevada",27105,15298,25799,5991,11807,31790,13.055201273,7.3683257361,12.426162614,2.8855823954,5.686875537,15.311745009
"1750","32005","Douglas County","Nevada",354,512,187,19,-158,206,7.4678817796,10.801004156,3.9448980022,0.4008185136,-3.333122376,4.3457165158
"1751","32007","Elko County","Nevada",789,267,-1371,12,522,-1359,15.128854119,5.1196502531,-26.28854119,0.2300966406,10.009203866,-26.05844455
"1752","32009","Esmeralda County","Nevada",3,5,6,1,-2,7,3.6253776435,6.0422960725,7.250755287,1.2084592145,-2.416918429,8.4592145015
"1753","32011","Eureka County","Nevada",28,15,27,0,13,27,13.940751805,7.4682598954,13.442867812,0,6.4724919094,13.442867812
"1754","32013","Humboldt County","Nevada",268,146,-345,22,122,-323,15.65329128,8.5275392792,-20.15069213,1.2849716722,7.1257520005,-18.86572046
"1755","32015","Lander County","Nevada",89,44,-147,11,45,-136,15.012229063,7.421776166,-24.79547946,1.8554440415,7.590452897,-22.94003542
"1756","32017","Lincoln County","Nevada",43,57,-46,-1,-14,-47,8.3220437391,11.031546352,-8.902651442,-0.193535901,-2.709502613,-9.096187343
"1757","32019","Lyon County","Nevada",589,576,649,-19,13,630,11.400919429,11.149286233,12.562303412,-0.367771594,0.2516331962,12.194531817
"1758","32021","Mineral County","Nevada",45,67,-33,8,-22,-25,10.122595883,15.071420538,-7.423236981,1.7995726015,-4.948824654,-5.62366438
"1759","32023","Nye County","Nevada",371,679,462,-19,-308,443,8.6440895164,15.820314775,10.764337888,-0.442689221,-7.176225259,10.321648668
"1760","32027","Pershing County","Nevada",49,44,-90,2,5,-88,7.3518379595,6.6016504126,-13.50337584,0.3000750188,0.7501875469,-13.20330083
"1761","32029","Storey County","Nevada",14,19,78,0,-5,78,3.6453586773,4.9472724906,20.309855488,0,-1.301913813,20.309855488
"1762","32031","Washoe County","Nevada",5451,3689,3979,466,1762,4445,12.399612839,8.3915193108,9.0511941821,1.0600292759,4.0080935282,10.111223458
"1763","32033","White Pine County","Nevada",100,103,-172,0,-3,-172,10.055304173,10.356963298,-17.29512318,0,-0.301659125,-17.29512318
"1764","32510","Carson City","Nevada",614,679,27,18,-65,45,11.35302547,12.554892988,0.4992372764,0.3328248509,-1.201867517,0.8320621273
"1765","33001","Belknap County","New Hampshire",532,696,194,35,-164,229,8.820213542,11.539226739,3.2163936601,0.5802772067,-2.719013197,3.7966708668
"1766","33003","Carroll County","New Hampshire",377,546,115,24,-169,139,7.9518250177,11.516436232,2.425623016,0.5062169773,-3.564611215,2.9318399933
"1767","33005","Cheshire County","New Hampshire",642,686,-209,98,-44,-111,8.4094704784,8.9858204801,-2.737662508,1.28368864,-0.576350002,-1.453973868
"1768","33007","Coos County","New Hampshire",258,444,-267,1,-186,-266,7.924441373,13.637410735,-8.200875374,0.030714889,-5.712969362,-8.170160485
"1769","33009","Grafton County","New Hampshire",794,819,-774,285,-25,-489,8.8546400433,9.1334385333,-8.631601251,3.1783027863,-0.27879849,-5.453298465
"1770","33011","Hillsborough County","New Hampshire",4230,3409,-1016,1971,821,955,10.369146519,8.3566005868,-2.490556232,4.8315810375,2.0125459319,2.3410248051
"1771","33013","Merrimack County","New Hampshire",1319,1441,104,567,-122,671,8.8878107617,9.70988272,0.7007826529,3.8206131174,-0.822071958,4.5213957704
"1772","33015","Rockingham County","New Hampshire",2609,2370,748,506,239,1254,8.6331982707,7.8423456886,2.4751369515,1.6743573496,0.7908525821,4.1494943011
"1773","33017","Strafford County","New Hampshire",1199,1074,-58,403,125,345,9.4595287593,8.4733393557,-0.457591883,3.1794746372,0.9861894036,2.7218827539
"1774","33019","Sullivan County","New Hampshire",420,436,10,10,-16,20,9.7314580968,10.10218031,0.2317013833,0.2317013833,-0.370722213,0.4634027665
"1775","34001","Atlantic County","New Jersey",3012,2631,-3722,1119,381,-2603,11.091328547,9.6883417691,-13.70581834,4.1205832153,1.4029867784,-9.585235129
"1776","34003","Bergen County","New Jersey",9431,7120,-3419,4396,2311,977,10.191521942,7.6941614066,-3.694710372,4.7504962842,2.4973605352,1.0557859121
"1777","34005","Burlington County","New Jersey",4533,4101,-2465,742,432,-1723,10.127945466,9.1627408683,-5.507475309,1.6578282673,0.9652045977,-3.849647041
"1778","34007","Camden County","New Jersey",6231,4684,-3587,1270,1547,-2317,12.261668854,9.2174060204,-7.058675362,2.4991685837,3.0442628338,-4.559506778
"1779","34009","Cape May County","New Jersey",921,1302,-503,148,-381,-355,9.7407233095,13.770273343,-5.319852144,1.5652845275,-4.029550034,-3.754567617
"1780","34011","Cumberland County","New Jersey",2023,1561,-2200,468,462,-1732,13.012826286,10.041038968,-14.15136818,3.0103819583,2.9717873178,-11.14098622
"1781","34013","Essex County","New Jersey",10187,5727,-7654,4698,4460,-2956,12.899157509,7.2517399681,-9.691778892,5.9487819749,5.6474175411,-3.742996917
"1782","34015","Gloucester County","New Jersey",2978,2505,-399,244,473,-155,10.245066251,8.6178277226,-1.372659985,0.8394211434,1.6272385281,-0.533238841
"1783","34017","Hudson County","New Jersey",10238,3700,-11357,8977,6538,-2380,15.45071632,5.5838689572,-17.13945939,13.547673413,9.8668473627,-3.591785978
"1784","34019","Hunterdon County","New Jersey",900,910,-531,84,-10,-447,7.1643787091,7.2439829169,-4.226983438,0.6686753462,-0.079604208,-3.558308092
"1785","34021","Mercer County","New Jersey",4161,3017,-4204,2354,1144,-1850,11.286072509,8.1831484643,-11.4027034,6.3848629384,3.1029240448,-5.017840457
"1786","34023","Middlesex County","New Jersey",9582,5828,-8822,6507,3754,-2315,11.613025204,7.0633177717,-10.69193366,7.8862403467,4.5497074322,-2.805693315
"1787","34025","Monmouth County","New Jersey",5779,5495,-2387,792,284,-1595,9.2466441114,8.7922321149,-3.81930083,1.267233455,0.4544119965,-2.552067375
"1788","34027","Morris County","New Jersey",4741,3737,-3100,1537,1004,-1563,9.583450406,7.5539662871,-6.266335427,3.1068895326,2.0294841189,-3.159445894
"1789","34029","Ocean County","New Jersey",8512,7231,1038,454,1281,1492,14.530730138,12.34395085,1.7719569882,0.7750177964,2.1867792889,2.5469747846
"1790","34031","Passaic County","New Jersey",6952,3720,-6403,2956,3232,-3447,13.775256453,7.3711096096,-12.68742334,5.8572580661,6.4041468436,-6.830165275
"1791","34033","Salem County","New Jersey",670,714,-636,68,-44,-568,10.46482569,11.152067975,-9.933774834,1.0621017119,-0.687242284,-8.871673123
"1792","34035","Somerset County","New Jersey",3449,2360,-2048,1291,1089,-757,10.467057145,7.1621498589,-6.215289369,3.9179387575,3.3049072866,-2.297350612
"1793","34037","Sussex County","New Jersey",1185,1169,-1657,42,16,-1615,8.2413570072,8.1300813008,-11.52399035,0.2920987294,0.1112757064,-11.23189162
"1794","34039","Union County","New Jersey",6776,3979,-4129,3414,2797,-715,12.335149807,7.243441718,-7.516504361,6.2149057615,5.0917080888,-1.3015986
"1795","34041","Warren County","New Jersey",858,994,-286,184,-136,-102,8.0283706525,9.3009329004,-2.676123551,1.7217018649,-1.272562248,-0.954421686
"1796","35001","Bernalillo County","New Mexico",7939,5462,-3444,1459,2477,-1985,11.73620951,8.0744648376,-5.091259044,2.1568370923,3.6617446728,-2.934421952
"1797","35003","Catron County","New Mexico",26,41,-53,-1,-15,-54,7.3968705548,11.664295875,-15.07823613,-0.284495021,-4.26742532,-15.36273115
"1798","35005","Chaves County","New Mexico",916,638,-390,113,278,-277,13.904279057,9.6844214393,-5.91994414,1.7152658662,4.2198576178,-4.204678274
"1799","35006","Cibola County","New Mexico",345,258,-216,19,87,-197,12.729453002,9.5194170279,-7.969744489,0.7010423393,3.2100359745,-7.268702149
"1800","35007","Colfax County","New Mexico",133,138,-275,8,-5,-267,10.569396432,10.966742162,-21.85401518,0.6357531688,-0.397345731,-21.21826201
"1801","35009","Curry County","New Mexico",896,441,-1508,218,455,-1290,17.670144162,8.6970240795,-29.7394837,4.2992091822,8.973120082,-25.44027452
"1802","35011","De Baca County","New Mexico",19,27,19,1,-8,20,10.18766756,14.477211796,10.18766756,0.5361930295,-4.289544236,10.72386059
"1803","35013","Doña Ana County","New Mexico",2922,1470,-1802,413,1452,-1389,13.646712669,6.8653893306,-8.415939846,1.9288474786,6.7813233388,-6.487092368
"1804","35015","Eddy County","New Mexico",918,540,531,119,378,650,16.046987257,9.4394042687,9.2820808642,2.0801650148,6.6075829881,11.362245879
"1805","35017","Grant County","New Mexico",303,332,-474,-1,-29,-475,10.589962254,11.603522997,-16.5664756,-0.03495037,-1.013560744,-16.60142598
"1806","35019","Guadalupe County","New Mexico",34,43,-84,0,-9,-84,7.732544917,9.7793950421,-19.1039345,0,-2.046850125,-19.1039345
"1807","35021","Harding County","New Mexico",3,7,29,0,-4,29,4.2492917847,9.9150141643,41.076487252,0,-5.66572238,41.076487252
"1808","35023","Hidalgo County","New Mexico",58,51,-122,1,7,-121,12.910406233,11.352253756,-27.15637173,0.2225932109,1.5581524763,-26.93377852
"1809","35025","Lea County","New Mexico",1186,544,459,183,642,642,16.738763787,7.6778140812,6.478155631,2.5827940751,9.0609497061,9.0609497061
"1810","35027","Lincoln County","New Mexico",192,217,-263,46,-25,-217,9.8537336413,11.136771876,-13.49756223,2.3607903516,-1.283038235,-11.13677188
"1811","35028","Los Alamos County","New Mexico",149,125,-90,90,24,0,8.3620955748,7.0151808514,-5.050930213,5.050930213,1.3469147235,0
"1812","35029","Luna County","New Mexico",415,310,-213,43,105,-170,16.997747287,12.697112431,-8.724144993,1.7612123694,4.3006348556,-6.962932623
"1813","35031","McKinley County","New Mexico",1118,623,64,106,495,170,15.287007411,8.5186096754,0.8751059699,1.4493942626,6.7683977357,2.3245002325
"1814","35033","Mora County","New Mexico",48,52,2,0,-4,2,10.401993715,11.268826525,0.4334164048,0,-0.86683281,0.4334164048
"1815","35035","Otero County","New Mexico",923,618,-1423,480,305,-943,14.188976257,9.5003112966,-21.87531226,7.3788825605,4.6886649603,-14.4964297
"1816","35037","Quay County","New Mexico",82,112,-13,23,-30,10,9.697256386,13.245033113,-1.537369915,2.719962157,-3.547776727,1.1825922422
"1817","35039","Rio Arriba County","New Mexico",515,391,-538,37,124,-501,13.020997939,9.8858450375,-13.60251824,0.9354891723,3.1351529019,-12.66702906
"1818","35041","Roosevelt County","New Mexico",298,154,-733,62,144,-671,15.362408496,7.9389627797,-37.78740076,3.1962057944,7.4234457161,-34.59119497
"1819","35043","Sandoval County","New Mexico",1467,1038,1055,13,429,1068,10.647022535,7.5334760678,7.656856697,0.0943498929,3.1135464673,7.75120659
"1820","35045","San Juan County","New Mexico",1857,1021,-1694,11,836,-1683,14.431427406,7.9345650949,-13.16469468,0.0854850304,6.4968623108,-13.07920965
"1821","35047","San Miguel County","New Mexico",313,284,-380,77,29,-303,11.03317001,10.010927421,-13.39490289,2.7142303218,1.0222425887,-10.68067257
"1822","35049","Santa Fe County","New Mexico",1333,1137,-20,235,196,215,9.0059961152,7.6817836331,-0.135123723,1.5877037412,1.3242124821,1.4525800186
"1823","35051","Sierra County","New Mexico",125,230,76,-1,-105,75,11.110123545,20.442627322,6.7549551151,-0.088880988,-9.332503777,6.6660741267
"1824","35053","Socorro County","New Mexico",189,177,-189,56,12,-133,10.984221079,10.286810217,-10.98422108,3.2545840235,0.6974108622,-7.729637056
"1825","35055","Taos County","New Mexico",305,289,-202,33,16,-169,9.2726305389,8.7861974614,-6.141217603,1.0032682222,0.4864330774,-5.137949381
"1826","35057","Torrance County","New Mexico",160,157,-119,54,3,-65,10.231160278,10.039326022,-7.609425456,3.4530165937,0.1918342552,-4.156408863
"1827","35059","Union County","New Mexico",39,54,-70,2,-15,-68,9.270263846,12.835749941,-16.63893511,0.4753981459,-3.565486095,-16.16353696
"1828","35061","Valencia County","New Mexico",825,672,-366,34,153,-332,10.880603511,8.8627461324,-4.827031376,0.4484127507,2.0178573784,-4.378618625
"1829","36001","Albany County","New York",3170,2660,-1296,1092,510,-204,10.31454481,8.6551070012,-4.216924313,3.55314919,1.6594378085,-0.663775123
"1830","36003","Allegany County","New York",503,512,-361,47,-9,-314,10.592818785,10.782352322,-7.602400758,0.9897862483,-0.189533537,-6.61261451
"1831","36005","Bronx County","New York",21479,9428,-16304,13346,12051,-2958,14.956146092,6.5648561553,-11.35271688,9.2930176335,8.3912899371,-2.059699248
"1832","36007","Broome County","New York",2046,2162,-1815,463,-116,-1352,10.411021639,11.00128484,-9.235583712,2.3559643298,-0.590263201,-6.879619382
"1833","36009","Cattaraugus County","New York",899,843,-834,40,56,-794,11.478842667,10.763809086,-10.64889297,0.5107382722,0.715033581,-10.1381547
"1834","36011","Cayuga County","New York",783,794,-509,52,-11,-457,9.9702039881,10.110270711,-6.481269259,0.6621335982,-0.140066723,-5.819135661
"1835","36013","Chautauqua County","New York",1423,1476,-1288,217,-53,-1071,10.846697969,11.250686017,-9.817671809,1.6540642722,-0.403988048,-8.163607537
"1836","36015","Chemung County","New York",1027,996,-534,45,31,-489,11.811589619,11.455056729,-6.14156656,0.5175477438,0.3565328902,-5.624018816
"1837","36017","Chenango County","New York",528,600,-490,5,-72,-485,10.764745459,12.232665294,-9.99000999,0.1019388774,-1.467919835,-9.888071113
"1838","36019","Clinton County","New York",775,695,-924,96,80,-828,9.5571052453,8.570565349,-11.3945358,1.1838478755,0.9865398963,-10.21068793
"1839","36021","Columbia County","New York",507,699,-370,79,-192,-291,8.2177792546,11.32983767,-5.997195906,1.2804823691,-3.112058416,-4.716713537
"1840","36023","Cortland County","New York",462,431,-510,28,31,-482,9.5219447851,8.8830264121,-10.51123775,0.5770875627,0.638918373,-9.934150187
"1841","36025","Delaware County","New York",390,521,-510,31,-131,-479,8.4310652327,11.263038426,-11.02523915,0.6701615954,-2.831973194,-10.35507755
"1842","36027","Dutchess County","New York",2688,2301,-1898,469,387,-1429,9.1234000957,7.8098748587,-6.442043669,1.5918432459,1.313525237,-4.850200423
"1843","36029","Erie County","New York",10363,9976,-4404,2809,387,-1595,11.249841913,10.829723335,-4.780884279,3.0493878156,0.4201185777,-1.731496463
"1844","36031","Essex County","New York",323,437,-262,23,-114,-239,8.470020585,11.459439615,-6.870419174,0.6031284008,-2.98941903,-6.267290773
"1845","36033","Franklin County","New York",478,464,-599,16,14,-583,9.4053756247,9.1299043721,-11.78623431,0.3148242887,0.2754712526,-11.47141002
"1846","36035","Fulton County","New York",548,579,-115,8,-31,-107,10.172165762,10.747598496,-2.134669822,0.1484987702,-0.575432735,-1.986171052
"1847","36037","Genesee County","New York",635,602,-311,11,33,-300,10.835252965,10.272161078,-5.306714444,0.1876972955,0.5630918864,-5.119017149
"1848","36039","Greene County","New York",364,559,-210,80,-195,-130,7.6153813967,11.695050002,-4.393489267,1.6737101971,-4.079668605,-2.71977907
"1849","36041","Hamilton County","New York",30,54,26,-1,-24,25,6.3836578359,11.490584105,5.5325034578,-0.212788595,-5.106926269,5.3197148633
"1850","36043","Herkimer County","New York",637,716,-673,17,-79,-656,10.108062648,11.361652835,-10.67931894,0.2697599137,-1.253590187,-10.40955902
"1851","36045","Jefferson County","New York",2140,912,-3475,607,1228,-2868,18.2587625,7.7813043923,-29.64915873,5.1790041296,10.477458107,-24.4701546
"1852","36047","Kings County","New York",42001,15812,-34171,15814,26189,-18357,16.113058805,6.0660385665,-13.10919579,6.0668058367,10.047020239,-7.042389955
"1853","36049","Lewis County","New York",334,266,-359,26,68,-333,12.388494279,9.8662858627,-13.31577678,0.9643738061,2.522208416,-12.35140298
"1854","36051","Livingston County","New York",490,517,-313,73,-27,-240,7.6025569416,8.0214733445,-4.856327189,1.1326258301,-0.418916403,-3.723701359
"1855","36053","Madison County","New York",643,616,-588,26,27,-562,8.938252384,8.562929189,-8.173705135,0.3614223359,0.375323195,-7.812282799
"1856","36055","Monroe County","New York",8460,6786,-5957,2210,1674,-3747,11.334397552,9.0916337811,-7.980970002,2.9608769019,2.2427637709,-5.0200931
"1857","36057","Montgomery County","New York",607,601,-251,150,6,-101,12.231491557,12.110587192,-5.057832588,3.0226091162,0.1209043646,-2.035223472
"1858","36059","Nassau County","New York",14318,11024,-6181,3221,3294,-2960,10.565432926,8.1347487481,-4.561037918,2.3768165564,2.4306841778,-2.184221362
"1859","36061","New York County","New York",18295,10212,-14389,12159,8083,-2230,11.197618846,6.2503461959,-8.806916511,7.4420250093,4.9472726499,-1.364891502
"1860","36063","Niagara County","New York",2216,2359,-959,154,-143,-805,10.411381105,11.08323467,-4.505647329,0.7235346075,-0.671853564,-3.782112721
"1861","36065","Oneida County","New York",2550,2642,-1947,637,-92,-1310,10.994696676,11.391368085,-8.394774285,2.7465183461,-0.396671409,-5.648255939
"1862","36067","Onondaga County","New York",5342,4434,-3543,1517,908,-2026,11.444179632,9.498969017,-7.590177543,3.2498728008,1.9452106151,-4.340304743
"1863","36069","Ontario County","New York",1025,1068,-141,144,-43,3,9.3770440813,9.7704225159,-1.289915332,1.3173603392,-0.393378435,0.0274450071
"1864","36071","Orange County","New York",4880,2651,-1725,466,2229,-1259,12.990245337,7.0567910634,-4.591838772,1.2404619523,5.9334542739,-3.35137682
"1865","36073","Orleans County","New York",450,447,-412,13,3,-399,10.803413879,10.73139112,-9.891125596,0.3120986232,0.0720227592,-9.579026973
"1866","36075","Oswego County","New York",1266,1095,-1091,50,171,-1041,10.536127432,9.1130012151,-9.079711713,0.4161187769,1.4231262171,-8.663592936
"1867","36077","Otsego County","New York",532,619,-413,46,-87,-367,8.760951189,10.193663132,-6.801264739,0.7575258547,-1.432711943,-6.043738884
"1868","36079","Putnam County","New York",858,710,-526,140,148,-386,8.6370911727,7.1472432781,-5.29499995,1.409315576,1.4898478946,-3.885684374
"1869","36081","Queens County","New York",30566,14756,-26359,17912,15810,-8447,13.267178296,6.4048446947,-11.44112912,7.7747071138,6.8623336014,-3.666422007
"1870","36083","Rensselaer County","New York",1619,1502,-575,265,117,-310,10.146748685,9.4134753084,-3.603693943,1.6608328607,0.7332733762,-1.942861082
"1871","36085","Richmond County","New York",5277,3738,-1967,898,1539,-1069,11.173030587,7.9144946623,-4.164743446,1.9013419494,3.2585359244,-2.263401497
"1872","36087","Rockland County","New York",5215,2049,-2156,887,3166,-1269,16.189266966,6.3608452567,-6.693012383,2.7535723488,9.8284217095,-3.939440035
"1873","36089","St. Lawrence County","New York",1139,914,-1487,139,225,-1348,10.27199596,8.2428483821,-13.41041088,1.2535622813,2.0291475776,-12.1568486
"1874","36091","Saratoga County","New York",2270,1781,701,367,489,1068,10.076103433,7.9055243236,3.1116072717,1.6290440352,2.1705791096,4.7406513069
"1875","36093","Schenectady County","New York",1792,1651,-844,407,141,-437,11.569500936,10.659177481,-5.449028343,2.6276712506,0.9103234554,-2.821357092
"1876","36095","Schoharie County","New York",237,302,-310,8,-65,-302,7.5022554249,9.5598360267,-9.813076716,0.2532406894,-2.057580602,-9.559836027
"1877","36097","Schuyler County","New York",174,187,-146,7,-13,-139,9.6193714238,10.338060093,-8.071426597,0.3869862067,-0.71868867,-7.68444039
"1878","36099","Seneca County","New York",384,373,-100,19,11,-81,11.018493278,10.702859356,-2.869399291,0.5451858653,0.315633922,-2.324213426
"1879","36101","Steuben County","New York",1092,992,-801,50,100,-751,11.160109762,10.138121688,-8.186124468,0.5109940367,1.0219880734,-7.675130431
"1880","36103","Suffolk County","New York",15819,11770,-10508,2961,4049,-7547,10.588229388,7.8780871041,-7.033384816,1.9819044958,2.7101422841,-5.051480321
"1881","36105","Sullivan County","New York",818,706,-1069,154,112,-915,10.870359665,9.3819974618,-14.20588568,2.0464980299,1.4883622036,-12.15938765
"1882","36107","Tioga County","New York",529,447,-551,-10,82,-561,10.666075227,9.0127327533,-11.10965492,-0.201627131,1.6533424738,-11.31128205
"1883","36109","Tompkins County","New York",863,710,-1380,842,153,-538,8.362281556,6.8797449649,-13.37189866,8.1587961415,1.482536591,-5.213102523
"1884","36111","Ulster County","New York",1554,1715,-869,311,-161,-558,8.6306722094,9.5248409518,-4.826289672,1.7272452105,-0.894168742,-3.099044461
"1885","36113","Warren County","New York",532,764,-261,36,-232,-225,8.2301343585,11.819215507,-4.037716292,0.5569263852,-3.589081149,-3.480789907
"1886","36115","Washington County","New York",601,641,-199,5,-40,-194,9.6399842809,10.281580572,-3.191941551,0.0801995364,-0.641596292,-3.111742014
"1887","36117","Wayne County","New York",962,863,-659,37,99,-622,10.508493091,9.4270577312,-7.198645475,0.4041728112,1.0814353597,-6.794472664
"1888","36119","Westchester County","New York",10778,7018,-5409,3491,3760,-1918,11.130692694,7.2476527488,-5.586000815,3.6052373534,3.8830399452,-1.980763461
"1889","36121","Wyoming County","New York",387,381,-215,4,6,-211,9.4331574265,9.2869069237,-5.240643015,0.0975003352,0.1462505027,-5.14314268
"1890","36123","Yates County","New York",290,284,-99,28,6,-71,11.547344111,11.308433543,-3.942024369,1.1149159831,0.2389105678,-2.827108386
"1891","37001","Alamance County","North Carolina",1779,1632,1376,154,147,1530,11.384689225,10.443964483,8.8056955444,0.9855211583,0.940724742,9.7912167027
"1892","37003","Alexander County","North Carolina",350,402,15,10,-52,25,9.4655993077,10.871916919,0.4056685418,0.2704456945,-1.406317611,0.6761142363
"1893","37005","Alleghany County","North Carolina",97,135,-3,8,-38,5,8.9170803457,12.410369553,-0.27578599,0.7354293069,-3.493289208,0.4596433168
"1894","37007","Anson County","North Carolina",237,312,-321,39,-75,-282,9.1871147808,12.094429585,-12.44330736,1.5118036981,-2.907314804,-10.93150366
"1895","37009","Ashe County","North Carolina",220,360,13,-4,-140,9,8.238311895,13.48087401,0.4868093392,-0.149787489,-5.242562115,0.3370218502
"1896","37011","Avery County","North Carolina",122,186,-113,18,-64,-95,6.9575135443,10.607356715,-6.444254348,1.0265183918,-3.649843171,-5.417735957
"1897","37013","Beaufort County","North Carolina",430,605,217,19,-175,236,9.0800629269,12.775437374,4.5822643143,0.4012120828,-3.695374447,4.9834763971
"1898","37015","Bertie County","North Carolina",163,269,-80,35,-106,-45,8.0517684252,13.287887769,-3.951788184,1.7289073306,-5.236119344,-2.222880854
"1899","37017","Bladen County","North Carolina",338,442,-182,43,-104,-139,9.8648688089,12.900213058,-5.311852436,1.2549981029,-3.035344249,-4.056854333
"1900","37019","Brunswick County","North Carolina",1111,1333,4060,-12,-222,4048,9.2383553898,11.084363397,33.760326627,-0.099784217,-1.846008008,33.66054241
"1901","37021","Buncombe County","North Carolina",2644,2576,2584,171,68,2755,10.552889173,10.281483551,10.313413624,0.6825053134,0.2714056217,10.995918938
"1902","37023","Burke County","North Carolina",896,1047,126,73,-151,199,10.032864349,11.723670729,1.4108715491,0.817409707,-1.69080638,2.2282812561
"1903","37025","Cabarrus County","North Carolina",2340,1551,3681,218,789,3899,12.071033389,8.000928541,18.988664062,1.1245663584,4.0701048478,20.11323042
"1904","37027","Caldwell County","North Carolina",802,976,-23,56,-174,33,9.8298167021,11.962470201,-0.281902474,0.686371241,-2.132653499,0.404468767
"1905","37029","Camden County","North Carolina",87,88,-4,12,-1,8,8.4630350195,8.560311284,-0.389105058,1.1673151751,-0.097276265,0.7782101167
"1906","37031","Carteret County","North Carolina",590,783,197,82,-193,279,8.591503149,11.40194401,2.8686883396,1.194073319,-2.810440861,4.0627616586
"1907","37033","Caswell County","North Carolina",205,260,54,15,-55,69,8.9847259659,11.395262201,2.3667083032,0.6574189731,-2.410536235,3.0241272763
"1908","37035","Catawba County","North Carolina",1774,1694,128,245,80,373,11.419008078,10.904058447,0.8239194104,1.5770332464,0.5149496315,2.4009526568
"1909","37037","Chatham County","North Carolina",647,653,1569,8,-6,1577,9.5907975778,9.6797385136,23.258054713,0.1185879144,-0.088940936,23.376642628
"1910","37039","Cherokee County","North Carolina",192,363,207,-12,-171,195,7.0884019715,13.401509977,7.6421833755,-0.443025123,-6.313108006,7.1991582523
"1911","37041","Chowan County","North Carolina",160,181,-237,1,-21,-236,11.129273467,12.58999061,-16.48523632,0.0695579592,-1.460717143,-16.41567836
"1912","37043","Clay County","North Carolina",68,132,125,-5,-64,120,6.420848874,12.464000755,11.803031018,-0.472121241,-6.043151881,11.330909778
"1913","37045","Cleveland County","North Carolina",1041,1228,-7,72,-187,65,10.737327427,12.666126878,-0.072201049,0.7426393609,-1.928799451,0.6704383119
"1914","37047","Columbus County","North Carolina",605,680,-157,24,-75,-133,10.656661735,11.977735503,-2.765447756,0.422743606,-1.321073769,-2.34270415
"1915","37049","Craven County","North Carolina",1485,1078,-2003,405,407,-1598,14.348935183,10.416264059,-19.35415298,3.9133459591,3.9326711243,-15.44080702
"1916","37051","Cumberland County","North Carolina",5470,2428,-5961,1763,3042,-4198,16.484319555,7.3169886433,-17.96399065,5.3129534506,9.1673309114,-12.6510372
"1917","37053","Currituck County","North Carolina",260,226,258,3,34,261,10.414789,9.0528550542,10.334675239,0.1201706423,1.3619339462,10.454845881
"1918","37055","Dare County","North Carolina",347,285,451,19,62,470,9.8683275033,8.1051104855,12.825981856,0.540340699,1.7632170179,13.366322555
"1919","37057","Davidson County","North Carolina",1702,1780,196,58,-78,254,10.409785933,10.886850153,1.1987767584,0.3547400612,-0.47706422,1.5535168196
"1920","37059","Davie County","North Carolina",360,464,483,9,-104,492,8.6830680174,11.191509889,11.649782923,0.2170767004,-2.508441872,11.866859624
"1921","37061","Duplin County","North Carolina",716,562,-842,131,154,-711,12.101340274,9.4985380364,-14.23090574,2.2140720334,2.6028022377,-12.01683371
"1922","37063","Durham County","North Carolina",4345,1986,1681,1474,2359,3155,14.581662343,6.6649439386,5.6413750055,4.9466905164,7.9167184044,10.588065522
"1923","37065","Edgecombe County","North Carolina",607,674,-1096,12,-67,-1084,11.176681796,12.41035178,-20.18063138,0.220955818,-1.233669984,-19.95967556
"1924","37067","Forsyth County","North Carolina",4410,3286,1269,452,1124,1721,12.051073598,8.9795527986,3.4677579128,1.235166727,3.071520799,4.7029246398
"1925","37069","Franklin County","North Carolina",706,586,756,58,120,814,11.178049225,9.278097515,11.96969577,0.918309993,1.8999517096,12.888005763
"1926","37071","Gaston County","North Carolina",2630,2261,1896,122,369,2018,12.419016678,10.676576696,8.9530249514,0.576091268,1.7424399826,9.5291162193
"1927","37073","Gates County","North Carolina",101,138,-71,7,-37,-64,8.7219343696,11.917098446,-6.131260794,0.6044905009,-3.195164076,-5.526770294
"1928","37075","Graham County","North Carolina",79,97,-14,7,-18,-7,9.1743119266,11.26466148,-1.62582743,0.812913715,-2.090349553,-0.812913715
"1929","37077","Granville County","North Carolina",554,519,153,2,35,155,9.5368433737,8.9343352183,2.6338213649,0.0344290375,0.6025081554,2.6682504024
"1930","37079","Greene County","North Carolina",211,210,-78,14,1,-64,10.054801048,10.007147963,-3.716940672,0.6671431975,0.0476530855,-3.049797474
"1931","37081","Guilford County","North Carolina",6178,4316,1692,1631,1862,3323,11.999739727,8.3831137363,3.2864292034,3.1679468267,3.616625991,6.45437603
"1932","37083","Halifax County","North Carolina",590,665,-602,12,-75,-590,11.236276031,12.664616205,-11.46481046,0.2285344278,-1.428340173,-11.23627603
"1933","37085","Harnett County","North Carolina",1901,975,124,281,926,405,14.925548912,7.6551342396,0.9735760469,2.206248945,7.2704146727,3.1798249919
"1934","37087","Haywood County","North Carolina",610,786,692,-19,-176,673,10.271954197,13.235665572,11.65277427,-0.319946114,-2.963711375,11.332828155
"1935","37089","Henderson County","North Carolina",1134,1419,1843,73,-285,1916,10.20720445,12.772507156,16.588957497,0.6570775351,-2.565302706,17.246035032
"1936","37091","Hertford County","North Carolina",221,271,-192,40,-50,-152,9.0274090111,11.06980924,-7.842816878,1.633920183,-2.042400229,-6.208896695
"1937","37093","Hoke County","North Carolina",949,310,306,190,639,496,18.194716055,5.9434794279,5.8667893708,3.6427777139,12.251236627,9.5095670846
"1938","37095","Hyde County","North Carolina",42,61,-154,1,-19,-153,7.6183566116,11.064756031,-27.93397424,0.1813894431,-3.44639942,-27.7525848
"1939","37097","Iredell County","North Carolina",1876,1483,2361,211,393,2572,11.166301103,8.8270919702,14.053111356,1.2559112648,2.339209133,15.309022621
"1940","37099","Jackson County","North Carolina",384,351,247,93,33,340,9.3444298438,8.5413929041,6.0106098214,2.2631041028,0.8030369397,8.2737139242
"1941","37101","Johnston County","North Carolina",2215,1354,3284,195,861,3479,12.107364721,7.4010708049,17.950603045,1.0658853818,4.7062939165,19.016488427
"1942","37103","Jones County","North Carolina",112,126,-60,10,-14,-50,11.40761866,12.833570992,-6.111224282,1.0185373803,-1.425952332,-5.092686902
"1943","37105","Lee County","North Carolina",773,606,-277,126,167,-151,13.005804661,10.196012451,-4.660553546,2.1199629848,2.80979221,-2.540590561
"1944","37107","Lenoir County","North Carolina",674,729,-273,65,-55,-208,11.595200206,12.541396069,-4.69657219,1.1182314739,-0.946195863,-3.578340717
"1945","37109","Lincoln County","North Carolina",800,781,1074,17,19,1091,10.002938363,9.765368577,13.428944753,0.2125624402,0.2375697861,13.641507193
"1946","37111","McDowell County","North Carolina",461,526,-22,52,-65,30,10.245127453,11.6896682,-0.488921484,1.1556325977,-1.444540747,0.6667111141
"1947","37113","Macon County","North Carolina",337,447,318,47,-110,365,9.9262161087,13.166227302,9.3665778118,1.3843684187,-3.240011193,10.750946231
"1948","37115","Madison County","North Carolina",214,240,-41,17,-26,-24,10.111749002,11.340279254,-1.937297706,0.8032697805,-1.228530253,-1.134027925
"1949","37117","Martin County","North Carolina",254,335,-89,-1,-81,-90,10.878177263,14.347202296,-3.811644789,-0.04282747,-3.469025033,-3.854472259
"1950","37119","Mecklenburg County","North Carolina",14593,5914,9299,4774,8679,14073,14.281002929,5.7875591943,9.1001881886,4.6719322951,8.4934437347,13.772120484
"1951","37121","Mitchell County","North Carolina",146,228,-42,24,-82,-18,9.6595983989,15.084852294,-2.778788581,1.5878791889,-5.425253895,-1.190909392
"1952","37123","Montgomery County","North Carolina",335,276,96,13,59,109,12.238113504,10.08274426,3.5070414817,0.4749118673,2.155369244,3.981953349
"1953","37125","Moore County","North Carolina",1060,1161,1148,134,-101,1282,11.346667452,12.427812181,12.288654938,1.4343900363,-1.081144729,13.723044975
"1954","37127","Nash County","North Carolina",1027,1002,-477,48,25,-429,10.924311646,10.658383904,-5.07390132,0.5105812649,0.2659277421,-4.563320055
"1955","37129","New Hanover County","North Carolina",2281,1926,2916,135,355,3051,10.476855382,8.8463057717,13.39347229,0.6200681616,1.63054961,14.013540451
"1956","37131","Northampton County","North Carolina",170,262,-48,22,-92,-26,8.2530281331,12.71937277,-2.330266767,1.0680389349,-4.466344637,-1.262227832
"1957","37133","Onslow County","North Carolina",4293,1078,-3451,1446,3215,-2005,22.309585119,5.6020807729,-17.9339339,7.514479404,16.707504346,-10.4194545
"1958","37135","Orange County","North Carolina",1229,778,-51,650,451,599,8.7252229227,5.5233713864,-0.362071903,4.6146419038,3.2018515363,4.2525700006
"1959","37137","Pamlico County","North Carolina",89,175,-50,5,-86,-45,6.9485107546,13.662802046,-3.903657727,0.3903657727,-6.714291291,-3.513291955
"1960","37139","Pasquotank County","North Carolina",515,408,-242,97,107,-145,13.063108766,10.349025974,-6.138392857,2.4604301948,2.7140827922,-3.677962662
"1961","37141","Pender County","North Carolina",626,539,1414,27,87,1441,11.04416785,9.5092755132,24.946411087,0.4763458977,1.534892337,25.422756984
"1962","37143","Perquimans County","North Carolina",108,146,-26,-5,-38,-31,7.9985187928,10.812812442,-1.925569339,-0.370301796,-2.814293649,-2.295871135
"1963","37145","Person County","North Carolina",408,446,122,4,-38,126,10.417730569,11.388009396,3.1151057093,0.1021346134,-0.970278827,3.2172403227
"1964","37147","Pitt County","North Carolina",2131,1256,84,162,875,246,12.139130039,7.1547383052,0.4785016064,0.9228245266,4.9843917333,1.401326133
"1965","37149","Polk County","North Carolina",152,303,178,4,-151,182,7.4560973217,14.863141372,8.7314823899,0.1962130874,-7.40704405,8.9276954773
"1966","37151","Randolph County","North Carolina",1619,1478,-93,96,141,3,11.355665909,10.366691917,-0.652301995,0.6733439946,0.9889739921,0.0210419998
"1967","37153","Richmond County","North Carolina",524,578,-316,28,-54,-288,11.4895903,12.673632048,-6.928836898,0.6139475733,-1.184041748,-6.314889325
"1968","37155","Robeson County","North Carolina",1783,1356,-975,65,427,-910,13.236527768,10.066590945,-7.238146144,0.4825430762,3.169936824,-6.755603067
"1969","37157","Rockingham County","North Carolina",954,1163,72,26,-209,98,10.399180274,12.677407399,0.7848437943,0.2834158146,-2.278227125,1.0682596089
"1970","37159","Rowan County","North Carolina",1591,1586,356,104,5,460,11.498572616,11.46243631,2.5729049977,0.7516351679,0.0361363061,3.3245401655
"1971","37161","Rutherford County","North Carolina",699,903,35,0,-204,35,10.514835847,13.583543304,0.5264939265,0,-3.068707457,0.5264939265
"1972","37163","Sampson County","North Carolina",844,695,-552,183,149,-369,13.247008044,10.908377477,-8.663919953,2.8722778105,2.338630567,-5.791642142
"1973","37165","Scotland County","North Carolina",440,379,-421,22,61,-399,12.395239101,10.676808226,-11.85999014,0.6197619551,1.7184308754,-11.24022819
"1974","37167","Stanly County","North Carolina",700,712,6,31,-12,37,11.546010853,11.743942468,0.0989658073,0.5113233378,-0.197931615,0.6102891451
"1975","37169","Stokes County","North Carolina",405,565,-18,2,-160,-16,8.7594082533,12.219915218,-0.389307033,0.0432563371,-3.460506964,-0.346050696
"1976","37171","Surry County","North Carolina",741,916,-397,56,-175,-341,10.258682154,12.681447845,-5.496217024,0.7752850211,-2.422765691,-4.720932003
"1977","37173","Swain County","North Carolina",222,182,48,-1,40,47,15.541865024,12.741528983,3.3604032484,-0.070008401,2.8003360403,3.2903948474
"1978","37175","Transylvania County","North Carolina",286,399,318,8,-113,326,8.6508068541,12.068782989,9.6187292993,0.2419806113,-3.417976135,9.8607099106
"1979","37177","Tyrrell County","North Carolina",37,44,21,1,-7,22,8.9620927698,10.657623834,5.0865931937,0.2422187235,-1.695531065,5.3288119172
"1980","37179","Union County","North Carolina",2365,1329,3115,111,1036,3226,10.75598913,6.0442746529,14.166979341,0.5048265511,4.7117144774,14.671805892
"1981","37181","Vance County","North Carolina",548,491,-158,48,57,-110,12.312254963,11.031600705,-3.54988373,1.0784456901,1.2806542571,-2.47143804
"1982","37183","Wake County","North Carolina",12765,5325,13234,3830,7440,17064,12.637237529,5.2717030818,13.101543396,3.7916662542,7.3655344467,16.89320965
"1983","37185","Warren County","North Carolina",174,233,-112,-2,-59,-114,8.5718508301,11.478397951,-5.517513178,-0.098527021,-2.906547121,-5.616040199
"1984","37187","Washington County","North Carolina",115,149,-190,9,-34,-181,9.2824279603,12.026797966,-15.33618533,0.7264508838,-2.744370006,-14.60973444
"1985","37189","Watauga County","North Carolina",374,329,591,20,45,611,7.0928038385,6.2393916119,11.208147242,0.3792943229,0.8534122266,11.587441565
"1986","37191","Wayne County","North Carolina",1698,1157,-1201,452,541,-749,13.635323357,9.2909712157,-9.64430115,3.6296620479,4.3443521415,-6.014639102
"1987","37193","Wilkes County","North Carolina",690,826,-36,42,-136,6,10.093400525,12.082824397,-0.526612201,0.6143809015,-1.989423872,0.0877687002
"1988","37195","Wilson County","North Carolina",944,837,61,119,107,180,11.633710648,10.315059124,0.7517546076,1.4665376771,1.3186515248,2.2182922847
"1989","37197","Yadkin County","North Carolina",356,438,-172,34,-82,-138,9.4332123268,11.606030896,-4.557619439,0.9009247728,-2.17281857,-3.656694666
"1990","37199","Yancey County","North Carolina",189,223,44,1,-34,45,10.768617173,12.705828728,2.5069796593,0.0569768104,-1.937211555,2.5639564697
"1991","38001","Adams County","North Dakota",25,31,5,9,-6,14,10.447137484,12.954450481,2.0894274969,3.7609694944,-2.507312996,5.8503969912
"1992","38003","Barnes County","North Dakota",101,131,-20,-5,-30,-25,9.1547699977,11.874008611,-1.812825742,-0.453206436,-2.719238613,-2.266032178
"1993","38005","Benson County","North Dakota",143,76,-134,0,67,-134,20.875912409,11.094890511,-19.5620438,0,9.7810218978,-19.5620438
"1994","38007","Billings County","North Dakota",18,1,10,1,17,11,19.282271023,1.0712372791,10.712372791,1.0712372791,18.211033744,11.78361007
"1995","38009","Bottineau County","North Dakota",67,67,42,7,0,49,9.9858409718,9.9858409718,6.2597809077,1.0432968179,0,7.3030777256
"1996","38011","Bowman County","North Dakota",48,45,36,0,3,36,14.726184998,13.805798435,11.044638748,0,0.9203865624,11.044638748
"1997","38013","Burke County","North Dakota",44,25,62,1,19,63,19.109663409,10.857763301,26.927252986,0.434310532,8.2519001086,27.361563518
"1998","38015","Burleigh County","North Dakota",1405,716,1825,132,689,1957,15.297595392,7.7957852675,19.870542057,1.4372118091,7.5018101247,21.307753867
"1999","38017","Cass County","North Dakota",2548,1074,1794,892,1474,2686,15.108794587,6.3684636526,10.637824761,5.2892640392,8.7403309348,15.9270888
"2000","38019","Cavalier County","North Dakota",47,49,-26,9,-2,-17,12.252346194,12.773722628,-6.777893639,2.346193952,-0.521376434,-4.431699687
"2001","38021","Dickey County","North Dakota",53,81,-33,5,-28,-28,10.453648915,15.976331361,-6.50887574,0.9861932939,-5.522682446,-5.522682446
"2002","38023","Divide County","North Dakota",35,31,7,15,4,22,14.332514333,12.694512695,2.8665028665,6.1425061425,1.638001638,9.009009009
"2003","38025","Dunn County","North Dakota",91,38,136,12,53,148,20.323841429,8.4868788386,30.374092686,2.6800670017,11.836962591,33.054159687
"2004","38027","Eddy County","North Dakota",27,49,-5,2,-22,-3,11.652999568,21.148036254,-2.157962883,0.8631851532,-9.495036685,-1.29477773
"2005","38029","Emmons County","North Dakota",33,41,-10,4,-8,-6,9.6887844979,12.03758074,-2.935995302,1.174398121,-2.348796242,-1.761597181
"2006","38031","Foster County","North Dakota",44,46,-7,-1,-2,-8,13.205282113,13.805522209,-2.100840336,-0.300120048,-0.600240096,-2.400960384
"2007","38033","Golden Valley County","North Dakota",23,15,19,0,8,19,12.32913428,8.0407397481,10.184937014,0,4.2883945323,10.184937014
"2008","38035","Grand Forks County","North Dakota",1054,449,-270,274,605,4,15.041993421,6.4078321119,-3.853262072,3.9103474358,8.634161309,0.057085364
"2009","38037","Grant County","North Dakota",23,33,31,2,-10,33,9.6415845735,13.833577866,12.995179208,0.8383986586,-4.191993293,13.833577866
"2010","38039","Griggs County","North Dakota",27,43,13,0,-16,13,11.79812104,18.789600175,5.680576797,0,-6.991479135,5.680576797
"2011","38041","Hettinger County","North Dakota",30,25,24,1,5,25,11.359333586,9.4661113215,9.0874668686,0.3786444529,1.8932222643,9.4661113215
"2012","38043","Kidder County","North Dakota",30,20,-12,2,10,-10,12.254901961,8.1699346405,-4.901960784,0.8169934641,4.0849673203,-4.08496732
"2013","38045","LaMoure County","North Dakota",56,42,27,0,14,27,13.605442177,10.204081633,6.5597667638,0,3.4013605442,6.5597667638
"2014","38047","Logan County","North Dakota",26,29,-15,7,-3,-8,13.436692506,14.987080103,-7.751937984,3.6175710594,-1.550387597,-4.134366925
"2015","38049","McHenry County","North Dakota",65,69,3,0,-4,3,10.876840696,11.546184739,0.5020080321,0,-0.669344043,0.5020080321
"2016","38051","McIntosh County","North Dakota",30,50,-7,5,-20,-2,10.978956999,18.298261665,-2.561756633,1.8298261665,-7.319304666,-0.731930467
"2017","38053","McKenzie County","North Dakota",235,56,1591,4,179,1595,19.784475501,4.7145984172,133.9451086,0.3367570298,15.069877084,134.28186563
"2018","38055","McLean County","North Dakota",121,94,82,1,27,83,12.597605414,9.7865694951,8.5372201978,0.1041124414,2.8110359188,8.6413326393
"2019","38057","Mercer County","North Dakota",97,87,66,0,10,66,11.086981369,9.9439935993,7.5437192822,0,1.14298777,7.5437192822
"2020","38059","Morton County","North Dakota",475,288,223,52,187,275,15.829639751,9.5977605225,7.4315992935,1.7329289832,6.2318792282,9.1645282767
"2021","38061","Mountrail County","North Dakota",151,95,469,18,56,487,15.065349696,9.4782001397,46.792377532,1.7958695001,5.587149556,48.588247032
"2022","38063","Nelson County","North Dakota",26,68,-62,1,-42,-61,8.7556827749,22.899478027,-20.87893585,0.3367570298,-14.14379525,-20.54217882
"2023","38065","Oliver County","North Dakota",20,12,-11,0,8,-11,10.709504685,6.4257028112,-5.890227577,0,4.2838018742,-5.890227577
"2024","38067","Pembina County","North Dakota",85,77,-74,30,8,-44,12.052463665,10.918114144,-10.49273307,4.2538107054,1.1343495214,-6.238922368
"2025","38069","Pierce County","North Dakota",49,64,-76,0,-15,-76,11.343905545,14.816529691,-17.59462901,0,-3.472624146,-17.59462901
"2026","38071","Ramsey County","North Dakota",173,158,18,1,15,19,14.874682946,13.584970552,1.547654873,0.0859808263,1.2897123941,1.6336356992
"2027","38073","Ransom County","North Dakota",61,82,27,5,-21,32,11.199853117,15.055540255,4.9573120353,0.9180207473,-3.855687139,5.8753327825
"2028","38075","Renville County","North Dakota",30,27,-24,1,3,-23,11.707317073,10.536585366,-9.365853659,0.3902439024,1.1707317073,-8.975609756
"2029","38077","Richland County","North Dakota",196,160,-92,-4,36,-96,12.011643941,9.8054236249,-5.638118584,-0.245135591,2.2062203156,-5.883254175
"2030","38079","Rolette County","North Dakota",286,142,-180,0,144,-180,19.44123445,9.652640881,-12.23574196,0,9.7885935694,-12.23574196
"2031","38081","Sargent County","North Dakota",43,39,-67,11,4,-56,11.044047772,10.016694491,-17.20816746,2.8252215231,1.0273532811,-14.38294594
"2032","38083","Sheridan County","North Dakota",13,15,-22,0,-2,-22,9.8335854766,11.346444781,-16.64145234,0,-1.512859304,-16.64145234
"2033","38085","Sioux County","North Dakota",106,47,-146,2,59,-144,23.992756904,10.638297872,-33.04662743,0.4526935265,13.354459031,-32.59393391
"2034","38087","Slope County","North Dakota",8,4,-2,0,4,-2,10.256410256,5.1282051282,-2.564102564,0,5.1282051282,-2.564102564
"2035","38089","Stark County","North Dakota",553,244,1136,84,309,1220,17.785067619,7.8472992748,36.534967115,2.7015292585,9.9377683439,39.236496374
"2036","38091","Steele County","North Dakota",25,20,-1,0,5,-1,13.065064019,10.452051215,-0.522602561,0,2.6130128038,-0.522602561
"2037","38093","Stutsman County","North Dakota",224,239,-86,34,-15,-52,10.624169987,11.335609941,-4.078922406,1.6125972301,-0.711439954,-2.466325175
"2038","38095","Towner County","North Dakota",25,31,-22,4,-6,-18,11.052166225,13.704686118,-9.725906278,1.7683465959,-2.652519894,-7.957559682
"2039","38097","Traill County","North Dakota",93,107,-39,6,-14,-33,11.601072787,13.347470841,-4.864966008,0.7484563089,-1.746398054,-4.116509699
"2040","38099","Walsh County","North Dakota",159,157,-81,22,2,-59,14.62270658,14.438773164,-7.449303352,2.0232675771,0.1839334161,-5.426035775
"2041","38101","Ward County","North Dakota",1301,481,622,395,820,1017,18.642039878,6.8922530216,8.9126432005,5.6599583026,11.749786856,14.572601503
"2042","38103","Wells County","North Dakota",39,53,-16,8,-14,-8,9.48097727,12.884405008,-3.8896317,1.9448158502,-3.403427738,-1.94481585
"2043","38105","Williams County","North Dakota",717,225,2616,19,492,2635,21.277858563,6.6771522687,77.633023711,0.5638484138,14.600706294,78.196872125
"2044","39001","Adams County","Ohio",304,333,-118,11,-29,-107,10.851135978,11.886277239,-4.211954097,0.3926397887,-1.035141261,-3.819314308
"2045","39003","Allen County","Ohio",1249,1109,-921,-2,140,-923,11.957016011,10.616758012,-8.816982984,-0.019146543,1.3402579997,-8.836129526
"2046","39005","Ashland County","Ohio",622,548,-44,107,74,63,11.686567024,10.296203745,-0.82670249,2.0103901472,1.3903632794,1.1836876568
"2047","39007","Ashtabula County","Ohio",1113,1208,-603,54,-95,-549,11.277224161,12.239790465,-6.109762955,0.5471429512,-0.962566303,-5.562620004
"2048","39009","Athens County","Ohio",543,500,764,348,43,1112,8.3074522283,7.6495876872,11.688569986,5.3241130303,0.6578645411,17.012683016
"2049","39011","Auglaize County","Ohio",564,469,-139,41,95,-98,12.324232194,10.248342019,-3.037355097,0.8959104964,2.0758901745,-2.141444601
"2050","39013","Belmont County","Ohio",706,865,-222,-13,-159,-235,10.208508054,12.507591313,-3.210040776,-0.187975361,-2.299083259,-3.398016137
"2051","39015","Brown County","Ohio",485,497,-222,-3,-12,-225,11.069521158,11.343406217,-5.066873602,-0.068471265,-0.27388506,-5.135344867
"2052","39017","Butler County","Ohio",4536,3287,170,886,1249,1056,12.099145778,8.7676129127,0.4534512307,2.3632811198,3.3315328652,2.8167323504
"2053","39019","Carroll County","Ohio",282,356,-344,3,-74,-341,10.098658884,12.74866157,-12.3189314,0.1074325413,-2.650002686,-12.21149886
"2054","39021","Champaign County","Ohio",393,432,-81,1,-39,-80,10.073694329,11.073373919,-2.07625761,0.02563281,-0.99967959,-2.0506248
"2055","39023","Clark County","Ohio",1629,1789,-457,52,-160,-405,11.975475637,13.151704061,-3.359602435,0.3822742377,-1.176228424,-2.977328197
"2056","39025","Clermont County","Ohio",2352,1726,-196,91,626,-105,11.661113755,8.5574329684,-0.97175948,0.4511740441,3.1036807869,-0.520585436
"2057","39027","Clinton County","Ohio",524,442,-55,10,82,-45,12.535285393,10.573656763,-1.31572652,0.2392230037,1.9616286302,-1.076503517
"2058","39029","Columbiana County","Ohio",1066,1337,-645,31,-271,-614,10.135343922,12.711965125,-6.132548621,0.2947426469,-2.576621203,-5.837805974
"2059","39031","Coshocton County","Ohio",462,364,-52,8,98,-44,12.639008576,9.9580067572,-1.422572394,0.2188572914,2.6810018193,-1.203715103
"2060","39033","Crawford County","Ohio",510,578,-46,32,-68,-14,12.03880745,13.643981777,-1.085853221,0.7553761537,-1.605174327,-0.330477067
"2061","39035","Cuyahoga County","Ohio",14990,13546,-9852,4062,1444,-5790,11.886420062,10.741390671,-7.812208836,3.2209898795,1.1450293909,-4.591218957
"2062","39037","Darke County","Ohio",614,648,-188,15,-34,-173,11.790120493,12.442993615,-3.61000432,0.2880322596,-0.652873122,-3.321972061
"2063","39039","Defiance County","Ohio",436,420,-257,45,16,-212,11.346484151,10.930099412,-6.688179878,1.1710820798,0.4163847395,-5.517097798
"2064","39041","Delaware County","Ohio",2157,1031,2327,384,1126,2711,11.271094111,5.3873426188,12.159404727,2.0065369211,5.8837514925,14.165941648
"2065","39043","Erie County","Ohio",806,969,-315,36,-163,-279,10.662574496,12.818901596,-4.167135194,0.4762440221,-2.1563271,-3.690891172
"2066","39045","Fairfield County","Ohio",1670,1248,292,153,422,445,11.075849674,8.2770421512,1.9366156315,1.014733533,2.7988075223,2.9513491645
"2067","39047","Fayette County","Ohio",345,360,-45,14,-15,-31,12.05345445,12.577517687,-1.572189711,0.4891256878,-0.524063237,-1.083064023
"2068","39049","Franklin County","Ohio",18872,9554,2343,7408,9318,9751,15.121316272,7.6552064258,1.877344427,5.9357095669,7.4661098467,7.8130539939
"2069","39051","Fulton County","Ohio",491,417,-207,21,74,-186,11.594682032,9.8472146787,-4.888185704,0.4959028975,1.7474673531,-4.392282806
"2070","39053","Gallia County","Ohio",352,379,-229,30,-27,-199,11.598787399,12.488467115,-7.54580203,0.988533017,-0.889679715,-6.557269013
"2071","39055","Geauga County","Ohio",906,856,-176,64,50,-112,9.6421957813,9.1100657713,-1.873097635,0.6811264128,0.53213001,-1.191971222
"2072","39057","Greene County","Ohio",1801,1470,-1383,625,331,-758,10.949493107,8.9371209703,-8.408189321,3.7997963309,2.0123721369,-4.60839299
"2073","39059","Guernsey County","Ohio",459,468,-300,7,-9,-293,11.609231742,11.836863737,-7.587733165,0.1770471072,-0.227631995,-7.410686058
"2074","39061","Hamilton County","Ohio",11099,8154,-3500,2571,2945,-929,13.725684182,10.083721851,-4.328308373,3.1794516652,3.6419623314,-1.148856708
"2075","39063","Hancock County","Ohio",939,747,1,178,192,179,12.444503346,9.8999403618,0.0132529322,2.3590219336,2.5445629846,2.3722748658
"2076","39065","Hardin County","Ohio",358,309,-218,19,49,-199,11.29248482,9.7468653892,-6.876429304,0.59932182,1.5456194306,-6.277107484
"2077","39067","Harrison County","Ohio",175,230,-69,0,-55,-69,11.324295467,14.883359757,-4.465007927,0,-3.55906429,-4.465007927
"2078","39069","Henry County","Ohio",312,294,-136,-2,18,-138,11.332885345,10.679065037,-4.939975663,-0.072646701,0.6538203084,-5.012622364
"2079","39071","Highland County","Ohio",516,499,-159,11,17,-148,11.994700016,11.599525791,-3.696041284,0.2557009693,0.3951742253,-3.440340315
"2080","39073","Hocking County","Ohio",312,289,-275,5,23,-270,10.900896179,10.097304474,-9.608161697,0.174693849,0.8035917055,-9.433467848
"2081","39075","Holmes County","Ohio",736,331,-315,3,405,-312,16.790619154,7.5512159511,-7.186202491,0.0684400237,9.239403203,-7.117762467
"2082","39077","Huron County","Ohio",724,577,-465,25,147,-440,12.383477294,9.8691524844,-7.953476439,0.4276062602,2.5143248097,-7.525870179
"2083","39079","Jackson County","Ohio",408,392,-246,20,16,-226,12.490433185,12.000612276,-7.530996479,0.6122761365,0.4898209092,-6.918720343
"2084","39081","Jefferson County","Ohio",707,1023,-42,-12,-316,-54,10.44644902,15.115583235,-0.62058113,-0.177308894,-4.669134215,-0.797890024
"2085","39083","Knox County","Ohio",745,603,-144,-2,142,-146,12.214816819,9.8866235459,-2.360984727,-0.032791455,2.3281932728,-2.393776182
"2086","39085","Lake County","Ohio",2297,2502,-168,406,-205,238,9.9923654326,10.884152509,-0.730830384,1.7661734287,-0.891787076,1.0353430444
"2087","39087","Lawrence County","Ohio",686,795,-489,-24,-109,-513,11.204207294,12.984467637,-7.986672546,-0.391983929,-1.780260343,-8.378656475
"2088","39089","Licking County","Ohio",1970,1643,738,144,327,882,11.58704251,9.6637110886,4.3407296308,0.8469716353,1.9233314218,5.187701266
"2089","39091","Logan County","Ohio",548,532,-246,25,16,-221,12.078332837,11.725680784,-5.422025325,0.5510188338,0.3526520536,-4.871006491
"2090","39093","Lorain County","Ohio",3456,3023,-29,576,433,547,11.333692977,9.9137019298,-0.095103326,1.8889488295,1.4199910472,1.793845503
"2091","39095","Lucas County","Ohio",5663,4518,-2728,576,1145,-2152,13.045651718,10.407955936,-6.28439659,1.3269107169,2.6376957827,-4.957485873
"2092","39097","Madison County","Ohio",424,402,88,41,22,129,9.6243332198,9.1249574396,1.9975031211,0.9306548632,0.4993757803,2.9281579843
"2093","39099","Mahoning County","Ohio",2433,3228,-1025,347,-795,-678,10.457926511,13.875128145,-4.405826006,1.4915332919,-3.417201634,-2.914292714
"2094","39101","Marion County","Ohio",763,796,-379,6,-33,-373,11.633669027,12.136829025,-5.778716332,0.0914836359,-0.503159997,-5.687232696
"2095","39103","Medina County","Ohio",1805,1486,-79,79,319,0,10.255710954,8.4432058046,-0.448864912,0.4488649115,1.8125051492,0
"2096","39105","Meigs County","Ohio",212,295,-10,-5,-83,-15,9.1269157913,12.700189427,-0.430514896,-0.215257448,-3.573273635,-0.645772344
"2097","39107","Mercer County","Ohio",572,406,-193,17,166,-176,14.045426642,9.9693063229,-4.739103745,0.4174340086,4.0761203192,-4.321669736
"2098","39109","Miami County","Ohio",1218,1046,-32,113,172,81,11.715762895,10.061320188,-0.307803294,1.0869303836,1.6544427077,0.7791270891
"2099","39111","Monroe County","Ohio",165,186,-79,2,-21,-77,11.531204137,12.998811937,-5.521000769,0.1397721714,-1.467607799,-5.381228597
"2100","39113","Montgomery County","Ohio",6647,6050,-2465,1273,597,-1192,12.490768632,11.368910821,-4.632126475,2.3921691694,1.1218578116,-2.239957306
"2101","39115","Morgan County","Ohio",146,156,12,1,-10,13,9.904684373,10.583087412,0.8140836471,0.0678403039,-0.678403039,0.881923951
"2102","39117","Morrow County","Ohio",366,328,-25,-1,38,-26,10.473301665,9.3859096892,-0.715389458,-0.028615578,1.0873919762,-0.744005036
"2103","39119","Muskingum County","Ohio",1058,1022,172,79,36,251,12.297034997,11.878610365,1.9991399049,0.9182096075,0.4184246313,2.9173495124
"2104","39121","Noble County","Ohio",144,134,-71,1,10,-70,9.9303496311,9.2407420178,-4.896214054,0.0689607613,0.6896076133,-4.827253293
"2105","39123","Ottawa County","Ohio",361,461,-41,-5,-100,-46,8.8417546352,11.290994146,-1.0041882,-0.122461976,-2.449239511,-1.126650175
"2106","39125","Paulding County","Ohio",213,194,-45,8,19,-37,11.231807636,10.229909302,-2.372917106,0.42185193,1.0018983337,-1.951065176
"2107","39127","Perry County","Ohio",436,371,-27,10,65,-17,12.128124174,10.320032267,-0.751053561,0.2781679856,1.8080919067,-0.472885576
"2108","39129","Pickaway County","Ohio",662,528,147,15,134,162,11.645191081,9.2880073882,2.5858656933,0.2638638463,2.3571836932,2.8497295396
"2109","39131","Pike County","Ohio",348,324,-84,-2,24,-86,12.307039414,11.458278075,-2.970664686,-0.070730112,0.8487613389,-3.041394798
"2110","39133","Portage County","Ohio",1476,1457,-520,667,19,147,9.0810092471,8.9641127866,-3.19927155,4.103681008,0.1168964605,0.9044094575
"2111","39135","Preble County","Ohio",446,450,-226,24,-4,-202,10.774898834,10.871534698,-5.459926315,0.5798151839,-0.096635864,-4.880111131
"2112","39137","Putnam County","Ohio",458,301,-342,5,157,-337,13.428131643,8.8250384813,-10.02712013,0.1465953236,4.6030931613,-9.880524811
"2113","39139","Richland County","Ohio",1401,1458,-276,54,-57,-222,11.49793185,11.965727792,-2.265117195,0.4431751034,-0.467795942,-1.821942092
"2114","39141","Ross County","Ohio",808,862,-9,28,-54,19,10.483771563,11.184419662,-0.116774683,0.3632990146,-0.700648099,0.2465243313
"2115","39143","Sandusky County","Ohio",676,668,-380,7,8,-373,11.333819547,11.199691506,-6.371081994,0.1173620367,0.134128042,-6.253719957
"2116","39145","Scioto County","Ohio",872,1002,-379,39,-130,-340,11.312187845,12.998637867,-4.916650451,0.5059350068,-1.686450023,-4.410715444
"2117","39147","Seneca County","Ohio",598,568,-265,69,30,-196,10.732328897,10.193917749,-4.755965147,1.238345642,0.5384111487,-3.517619505
"2118","39149","Shelby County","Ohio",642,429,-265,77,213,-188,13.110870586,8.7610023077,-5.411807952,1.5724875937,4.3498682786,-3.839320359
"2119","39151","Stark County","Ohio",4238,4220,-983,145,18,-838,11.29719103,11.249208624,-2.62037253,0.3865249409,0.0479824065,-2.233847589
"2120","39153","Summit County","Ohio",6086,5996,-1983,1306,90,-677,11.225727316,11.059720832,-3.657676186,2.4089385269,0.1660064835,-1.248737659
"2121","39155","Trumbull County","Ohio",2103,2606,-1144,3,-503,-1141,10.300794969,12.764560955,-5.603475722,0.0146944293,-2.463765986,-5.588781293
"2122","39157","Tuscarawas County","Ohio",1191,1015,-156,95,176,-61,12.84505584,10.946877983,-1.682475828,1.0245846388,1.8981778571,-0.657891189
"2123","39159","Union County","Ohio",660,377,246,108,283,354,12.213627447,6.9765720419,4.5523520486,1.9985935823,5.2370554055,6.5509456309
"2124","39161","Van Wert County","Ohio",315,332,4,11,-17,15,11.119543922,11.719646293,0.1412005577,0.3883015338,-0.60010237,0.5295020915
"2125","39163","Vinton County","Ohio",148,134,-143,0,14,-143,11.257321062,10.19243934,-10.87700616,0,1.0648817221,-10.87700616
"2126","39165","Warren County","Ohio",2344,1645,1409,509,699,1918,10.529956919,7.3898375134,6.3296541376,2.2865819418,3.1401194054,8.6162360795
"2127","39167","Washington County","Ohio",572,763,23,31,-191,54,9.3648441785,12.491916273,0.3765584198,0.5075352614,-3.127072095,0.8840936812
"2128","39169","Wayne County","Ohio",1593,1117,-279,135,476,-144,13.723412504,9.6227569155,-2.403535523,1.1630010596,4.100655588,-1.240534464
"2129","39171","Williams County","Ohio",419,403,-200,-2,16,-202,11.294713858,10.863412136,-5.391271531,-0.053912715,0.4313017225,-5.445184247
"2130","39173","Wood County","Ohio",1386,1130,-507,222,256,-285,10.717516877,8.7379466599,-3.920476953,1.7166585473,1.9795702167,-2.203818405
"2131","39175","Wyandot County","Ohio",251,267,-101,15,-16,-86,11.291302099,12.011066376,-4.543512,0.6747790099,-0.719764277,-3.86873299
"2132","40001","Adair County","Oklahoma",314,268,-182,8,46,-174,14.162006134,12.087317337,-8.208551326,0.3608154429,2.0746887967,-7.847735883
"2133","40003","Alfalfa County","Oklahoma",69,55,73,3,14,76,11.779769526,9.3896713615,12.462654716,0.5121638924,2.3900981647,12.974818609
"2134","40005","Atoka County","Oklahoma",174,194,-27,9,-20,-18,12.51573458,13.954324762,-1.942096745,0.6473655817,-1.438590182,-1.294731163
"2135","40007","Beaver County","Oklahoma",53,52,-94,12,1,-82,9.6635974109,9.4812653843,-17.1392105,2.1879843194,0.1823320266,-14.95122618
"2136","40009","Beckham County","Oklahoma",347,245,-155,14,102,-141,14.715860899,10.390161154,-6.57336726,0.5937234945,4.3256997455,-5.979643766
"2137","40011","Blaine County","Oklahoma",162,137,-120,7,25,-113,16.544117647,13.991013072,-12.25490196,0.714869281,2.5531045752,-11.54003268
"2138","40013","Bryan County","Oklahoma",577,496,433,31,81,464,12.888670479,11.079342387,9.6720872051,0.6924588992,1.8093280915,10.364546104
"2139","40015","Caddo County","Oklahoma",382,355,-93,37,27,-56,12.974221377,12.057195259,-3.158645518,1.2566654213,0.9170261183,-1.901980097
"2140","40017","Canadian County","Oklahoma",1732,941,2886,133,791,3019,13.190562503,7.1664661173,21.979193639,1.0129011622,6.0240963855,22.992094801
"2141","40019","Carter County","Oklahoma",718,630,-138,33,88,-105,14.783244284,12.971370333,-2.841347787,0.6794527317,1.8118739512,-2.161895055
"2142","40021","Cherokee County","Oklahoma",529,541,82,72,-12,154,10.951247283,11.199668771,1.6975468378,1.4905289308,-0.248421488,3.1880757686
"2143","40023","Choctaw County","Oklahoma",212,234,-96,0,-22,-96,14.099494546,15.562649641,-6.384676776,0,-1.463155094,-6.384676776
"2144","40025","Cimarron County","Oklahoma",35,34,-72,0,1,-72,15.635470181,15.188742461,-32.1643958,0,0.4467277195,-32.1643958
"2145","40027","Cleveland County","Oklahoma",2924,1920,2256,947,1004,3203,10.751027672,7.0594983344,8.2949105429,3.4819504806,3.6915293374,11.776861023
"2146","40029","Coal County","Oklahoma",72,89,-102,0,-17,-102,12.739980536,15.748031496,-18.04830576,0,-3.00805096,-18.04830576
"2147","40031","Comanche County","Oklahoma",1909,1015,-2151,457,894,-1694,15.34134287,8.1568690481,-17.28613332,3.6726001527,7.1844738217,-13.61353317
"2148","40033","Cotton County","Oklahoma",65,90,-102,0,-25,-102,10.736703006,14.866204163,-16.84836472,0,-4.129501156,-16.84836472
"2149","40035","Craig County","Oklahoma",161,206,119,5,-45,124,10.975526621,14.043220397,8.1123457632,0.340854864,-3.067693776,8.4532006272
"2150","40037","Creek County","Oklahoma",877,887,181,66,-10,247,12.414183594,12.555736429,2.5621063062,0.9342487083,-0.141552835,3.4963550145
"2151","40039","Custer County","Oklahoma",441,327,-147,92,114,-55,14.972499491,11.102057446,-4.990833164,3.123514633,3.8704420452,-1.867318531
"2152","40041","Delaware County","Oklahoma",416,565,91,17,-149,108,9.9835607233,13.559403386,2.1839039082,0.4079820488,-3.575842663,2.591885957
"2153","40043","Dewey County","Oklahoma",53,76,27,11,-23,38,10.681176945,15.316404676,5.4413542926,2.2168480451,-4.635227731,7.6582023378
"2154","40045","Ellis County","Oklahoma",44,65,115,11,-21,126,10.546500479,15.580057526,27.564717162,2.6366251198,-5.033557047,30.201342282
"2155","40047","Garfield County","Oklahoma",1034,690,-12,148,344,136,16.399812845,10.943782266,-0.190326648,2.3473619934,5.4560305791,2.1570353452
"2156","40049","Garvin County","Oklahoma",406,345,184,54,61,238,14.629312675,12.431312494,6.6300333303,1.9457706513,2.1980001802,8.5758039816
"2157","40051","Grady County","Oklahoma",622,515,539,54,107,593,11.465860493,9.4934375461,9.9358501696,0.9954284029,1.9724229465,10.931278572
"2158","40053","Grant County","Oklahoma",61,57,24,0,4,24,13.638904416,12.744550028,5.3661263276,0,0.8943543879,5.3661263276
"2159","40055","Greer County","Oklahoma",70,89,-69,-1,-19,-70,11.526428454,14.655030463,-11.36176519,-0.164663264,-3.128602009,-11.52642845
"2160","40057","Harmon County","Oklahoma",32,22,-37,8,10,-29,11.535688536,7.9307858688,-13.33813987,2.8839221341,3.6049026676,-10.45421774
"2161","40059","Harper County","Oklahoma",56,38,-117,50,18,-67,14.468414933,9.8178529906,-30.22865263,12.918227619,4.6505619429,-17.31042501
"2162","40061","Haskell County","Oklahoma",168,141,-112,10,27,-102,13.189919133,11.070110701,-8.793279422,0.7851142341,2.1198084321,-8.008165188
"2163","40063","Hughes County","Oklahoma",156,207,-44,6,-51,-38,11.444501504,15.185973149,-3.227936322,0.4401731348,-3.741471646,-2.787763187
"2164","40065","Jackson County","Oklahoma",405,274,-625,128,131,-497,15.791628487,10.683719026,-24.36979705,4.9909344355,5.1079094613,-19.37886261
"2165","40067","Jefferson County","Oklahoma",81,91,-17,3,-10,-14,12.896035663,14.488138831,-2.706575386,0.4776309505,-1.592103168,-2.228944436
"2166","40069","Johnston County","Oklahoma",127,133,-126,-2,-6,-128,11.519796816,12.064039185,-11.42908975,-0.181414123,-0.544242369,-11.61050388
"2167","40071","Kay County","Oklahoma",602,607,-217,11,-5,-206,13.265609678,13.375789161,-4.781789535,0.2423948612,-0.110179482,-4.539394674
"2168","40073","Kingfisher County","Oklahoma",225,156,0,10,69,10,14.499291146,10.052841861,0,0.6444129398,4.4464492847,0.6444129398
"2169","40075","Kiowa County","Oklahoma",117,155,-132,1,-38,-131,12.722231284,16.854238025,-14.35328658,0.1087370195,-4.132006742,-14.24454956
"2170","40077","Latimer County","Oklahoma",129,149,-144,6,-20,-138,12.077520831,13.950004681,-13.48188372,0.5617451549,-1.87248385,-12.92013856
"2171","40079","Le Flore County","Oklahoma",632,615,-268,72,17,-196,12.671806234,12.330950686,-5.373487454,1.443623495,0.3408555474,-3.929863959
"2172","40081","Lincoln County","Oklahoma",429,360,323,5,69,328,12.351899572,10.36523041,9.2999150627,0.1439615335,1.986669162,9.4438765962
"2173","40083","Logan County","Oklahoma",558,391,485,19,167,504,12.393390192,8.684257285,10.772032694,0.4219971571,3.7091329069,11.194029851
"2174","40085","Love County","Oklahoma",102,113,73,4,-11,77,10.458320517,11.586178612,7.4848764483,0.4101302163,-1.127858095,7.8950066646
"2175","40087","McClain County","Oklahoma",406,348,650,16,58,666,10.792131845,9.2503987241,17.278043594,0.4253056885,1.5417331207,17.703349282
"2176","40089","McCurtain County","Oklahoma",450,430,-104,52,20,-52,13.57793736,12.974473478,-3.13801219,1.569006095,0.6034638827,-1.569006095
"2177","40091","McIntosh County","Oklahoma",201,300,-46,4,-99,-42,10.106342861,15.084093823,-2.312894386,0.201121251,-4.977750962,-2.111773135
"2178","40093","Major County","Oklahoma",107,95,-43,12,12,-31,13.771799987,12.227299054,-5.534461677,1.5445009331,1.5445009331,-3.989960744
"2179","40095","Marshall County","Oklahoma",176,219,137,14,-43,151,10.859840188,13.513096597,8.4533983278,0.863850924,-2.653256409,9.3172492518
"2180","40097","Mayes County","Oklahoma",473,514,5,9,-41,14,11.564509425,12.566929904,0.1222463998,0.2200435197,-1.002420479,0.3422899196
"2181","40099","Murray County","Oklahoma",159,194,109,14,-35,123,11.515480717,14.050334963,7.8942603657,1.0139416984,-2.534854246,8.9082020641
"2182","40101","Muskogee County","Oklahoma",943,990,-379,17,-47,-362,13.561125732,14.237024893,-5.450335792,0.2444741648,-0.675899162,-5.205861628
"2183","40103","Noble County","Oklahoma",120,128,6,3,-8,9,10.404924998,11.098586664,0.5202462499,0.2601231249,-0.693661667,0.7803693748
"2184","40105","Nowata County","Oklahoma",124,156,47,2,-32,49,11.811211125,14.859265609,4.4768300233,0.1905034052,-3.048054484,4.6673334286
"2185","40107","Okfuskee County","Oklahoma",148,184,-28,12,-36,-16,12.188091905,15.152762909,-2.305855225,0.988223668,-2.964671004,-1.317631557
"2186","40109","Oklahoma County","Oklahoma",12550,7028,1895,3133,5522,5028,16.244430134,9.0968808753,2.4528442314,4.0552828375,7.1475492591,6.508127069
"2187","40111","Okmulgee County","Oklahoma",502,534,15,3,-32,18,12.84281621,13.661481785,0.3837494883,0.0767498977,-0.818665575,0.460499386
"2188","40113","Osage County","Oklahoma",443,463,-137,7,-20,-130,9.3424437977,9.7642245561,-2.889198195,0.1476232654,-0.421780758,-2.741574929
"2189","40115","Ottawa County","Oklahoma",487,462,-101,17,25,-84,15.278431373,14.494117647,-3.168627451,0.5333333333,0.7843137255,-2.635294118
"2190","40117","Pawnee County","Oklahoma",198,197,78,7,1,85,12.06912316,12.008167992,4.754503063,0.4266861723,0.0609551675,5.1811892353
"2191","40119","Payne County","Oklahoma",950,563,-289,698,387,409,11.738902104,6.9568440888,-3.571097587,8.6250038615,4.7820580149,5.0539062741
"2192","40121","Pittsburg County","Oklahoma",488,638,26,6,-150,32,10.899425993,14.249659393,0.5807071226,0.134009336,-3.3502334,0.7147164586
"2193","40123","Pontotoc County","Oklahoma",518,439,-87,60,79,-27,13.513866061,11.452871044,-2.269703373,1.5653126712,2.0609950171,-0.704390702
"2194","40125","Pottawatomie County","Oklahoma",920,863,-128,33,57,-95,12.864074276,12.067060979,-1.789784247,0.4614287512,0.7970132975,-1.328355496
"2195","40127","Pushmataha County","Oklahoma",158,178,54,6,-20,60,14.204162359,16.002157594,4.8545871353,0.5393985706,-1.797995235,5.3939857059
"2196","40129","Roger Mills County","Oklahoma",54,41,4,0,13,4,14.331210191,10.881104034,1.0615711253,0,3.4501061571,1.0615711253
"2197","40131","Rogers County","Oklahoma",999,921,610,64,78,674,11.128377362,10.259495046,6.7951052963,0.7129290803,0.8688823166,7.5080343765
"2198","40133","Seminole County","Oklahoma",304,388,121,7,-84,128,11.977463457,15.287025728,4.7673456523,0.2757968559,-3.309562271,5.0431425082
"2199","40135","Sequoyah County","Oklahoma",525,507,-125,32,18,-93,12.677025608,12.24238473,-3.01833943,0.7726948942,0.434640878,-2.245644536
"2200","40137","Stephens County","Oklahoma",534,601,49,39,-67,88,11.97309417,13.475336323,1.0986547085,0.8744394619,-1.502242152,1.9730941704
"2201","40139","Texas County","Oklahoma",388,199,-587,96,189,-491,17.974613175,9.2189382007,-27.19355138,4.4473269712,8.7556749745,-22.7462244
"2202","40141","Tillman County","Oklahoma",94,97,-112,15,-3,-97,12.31333508,12.706313859,-14.67120775,1.9648938957,-0.392978779,-12.70631386
"2203","40143","Tulsa County","Oklahoma",9651,5785,3492,2194,3866,5686,15.169519498,9.0929095739,5.4887537134,3.4485468635,6.0766099244,8.9373005769
"2204","40145","Wagoner County","Oklahoma",866,601,767,72,265,839,11.362369041,7.8854316323,10.063437707,0.9446773336,3.4769374086,11.008115041
"2205","40147","Washington County","Oklahoma",691,672,-51,138,19,87,13.274166282,12.909174735,-0.979714154,2.6509912402,0.3649915476,1.6712770862
"2206","40149","Washita County","Oklahoma",179,138,81,5,41,86,15.310268144,11.803446949,6.9281101655,0.4276611213,3.5068211949,7.3557712868
"2207","40151","Woods County","Oklahoma",130,98,10,15,32,25,14.032057855,10.578012845,1.0793890658,1.6190835987,3.4540450105,2.6984726645
"2208","40153","Woodward County","Oklahoma",315,187,-107,55,128,-52,14.601923746,8.6684436203,-4.960018542,2.5495422413,5.9334801252,-2.410476301
"2209","41001","Baker County","Oregon",156,215,-85,7,-59,-78,9.7851654383,13.485965187,-5.331660655,0.4390779363,-3.700799749,-4.892582719
"2210","41003","Benton County","Oregon",719,576,509,400,143,909,8.1941524067,6.564439202,5.8008672809,4.5586383347,1.6297132047,10.359505616
"2211","41005","Clackamas County","Oregon",4121,3415,5432,172,706,5604,10.390140838,8.6101264163,13.695521726,0.4336579044,1.7800144216,14.12917963
"2212","41007","Clatsop County","Oregon",427,420,338,13,7,351,11.350345561,11.164274322,8.9845826688,0.3455608719,0.1860712387,9.3301435407
"2213","41009","Columbia County","Oregon",537,458,76,7,79,83,10.831526398,9.2380616207,1.5329534567,0.1411930815,1.5934647774,1.6741465382
"2214","41011","Coos County","Oregon",606,903,584,3,-297,587,9.6943713456,14.445573144,9.3424304717,0.0479919374,-4.751201798,9.390422409
"2215","41013","Crook County","Oregon",226,276,551,-6,-50,545,10.656356092,13.013956997,25.980761977,-0.282912109,-2.357600905,25.697849868
"2216","41015","Curry County","Oregon",174,385,385,-23,-211,362,7.8314879827,17.328292376,17.328292376,-1.035196687,-9.496804393,16.293095688
"2217","41017","Deschutes County","Oregon",1813,1396,4291,-41,417,4250,10.548363636,8.1221818182,24.965818182,-0.238545455,2.4261818182,24.727272727
"2218","41019","Douglas County","Oregon",1119,1403,779,-2,-284,777,10.463175513,13.118708887,7.2840158397,-0.018700939,-2.655533374,7.2653149004
"2219","41021","Gilliam County","Oregon",17,22,-58,1,-5,-57,8.9520800421,11.58504476,-30.54239073,0.5265929437,-2.632964718,-30.01579779
"2220","41023","Grant County","Oregon",69,81,31,0,-12,31,9.5839988888,11.250781304,4.3058545732,0,-1.666782415,4.3058545732
"2221","41025","Harney County","Oregon",94,99,23,5,-5,28,13.168954889,13.869431213,3.2221910899,0.7004763239,-0.700476324,3.9226674138
"2222","41027","Hood River County","Oregon",295,184,150,-1,111,149,12.924424973,8.0613362541,6.5717415115,-0.04381161,4.8630887185,6.5279299014
"2223","41029","Jackson County","Oregon",2323,2288,2231,-70,35,2161,11.044601553,10.878195589,10.60719159,-0.332811928,0.166405964,10.274379662
"2224","41031","Jefferson County","Oregon",291,217,269,-2,74,267,13.00180953,9.6955074503,12.018854858,-0.089359516,3.3063020798,11.929495342
"2225","41033","Josephine County","Oregon",879,1194,1461,-18,-315,1443,10.472264583,14.225123904,17.406118948,-0.214449104,-3.752859321,17.191669844
"2226","41035","Klamath County","Oregon",816,754,340,-12,62,328,12.463914219,11.516901129,5.1932975912,-0.183292856,0.9470130902,5.0100047351
"2227","41037","Lake County","Oregon",83,98,-25,2,-15,-23,10.637616149,12.560076898,-3.20410125,0.2563281,-1.92246075,-2.94777315
"2228","41039","Lane County","Oregon",3709,3524,3296,470,185,3766,10.301018021,9.787216906,9.1539917486,1.3053325612,0.5138011145,10.45932431
"2229","41041","Lincoln County","Oregon",424,539,756,9,-115,765,9.0835082908,11.547195681,16.19606667,0.1928103175,-2.46368739,16.388876987
"2230","41043","Linn County","Oregon",1471,1293,1014,-11,178,1003,12.293831773,10.806202911,8.4744700322,-0.091932121,1.4876288617,8.3825379116
"2231","41045","Malheur County","Oregon",388,316,-180,-19,72,-199,12.804646635,10.428526641,-5.940299985,-0.627031665,2.3761199941,-6.56733165
"2232","41047","Marion County","Oregon",4405,2850,3046,91,1555,3137,13.473729287,8.7173957927,9.3169079244,0.2783449183,4.7563334939,9.5952528427
"2233","41049","Morrow County","Oregon",164,66,-59,-2,98,-61,14.736936694,5.9307184257,-5.301702835,-0.17971874,8.8062182684,-5.481421575
"2234","41051","Multnomah County","Oregon",9464,5707,5190,2574,3757,7764,12.06501134,7.2754670029,6.6163787883,3.2814179193,4.7895443367,9.8977967076
"2235","41053","Polk County","Oregon",815,701,1115,63,114,1178,10.40323713,8.9480604026,14.23264957,0.8041766125,1.4551767274,15.036826183
"2236","41055","Sherman County","Oregon",21,24,-21,0,-3,-21,12.349309027,14.113496031,-12.34930903,0,-1.764187004,-12.34930903
"2237","41057","Tillamook County","Oregon",242,295,295,-1,-53,294,9.5103356127,11.59317771,11.59317771,-0.039298907,-2.082842097,11.553878802
"2238","41059","Umatilla County","Oregon",1017,671,-540,-16,346,-556,13.276242445,8.7594480634,-7.049332272,-0.208869104,4.5167943814,-7.258201376
"2239","41061","Union County","Oregon",292,277,39,15,15,54,11.377140519,10.792698369,1.5195495899,0.58444215,0.58444215,2.1039917399
"2240","41063","Wallowa County","Oregon",54,80,59,0,-26,59,7.9470198675,11.773362767,8.6828550405,0,-3.826342899,8.6828550405
"2241","41065","Wasco County","Oregon",305,331,212,-7,-26,205,12.02444313,13.049477627,8.3579735856,-0.275970826,-1.025034496,8.0820027597
"2242","41067","Washington County","Oregon",7046,3319,4869,1690,3727,6559,12.411364695,5.8463411047,8.5766299604,2.9768955911,6.5650235906,11.553525552
"2243","41069","Wheeler County","Oregon",8,26,-6,0,-18,-6,5.9790732436,19.431988042,-4.484304933,0,-13.4529148,-4.484304933
"2244","41071","Yamhill County","Oregon",1091,954,455,52,137,507,10.787987857,9.4333092721,4.4991150092,0.5141845725,1.3546785852,5.0132995817
"2245","42001","Adams County","Pennsylvania",1029,1029,385,55,0,440,10.131642429,10.131642429,3.7907505686,0.5415357955,0,4.3322863641
"2246","42003","Allegheny County","Pennsylvania",13173,14159,-6368,3324,-986,-3044,10.700890888,11.501853343,-5.172950214,2.7002020278,-0.800962455,-2.472748187
"2247","42005","Armstrong County","Pennsylvania",615,849,-481,3,-234,-478,9.1641272845,12.650965959,-7.167390608,0.0447030599,-3.486838674,-7.122687548
"2248","42007","Beaver County","Pennsylvania",1663,2177,-206,12,-514,-194,9.8616814671,12.909729738,-1.22159133,0.07116066,-3.048048271,-1.15043067
"2249","42009","Bedford County","Pennsylvania",461,559,-291,9,-98,-282,9.4222967104,11.425301217,-5.947697056,0.1839493935,-2.003004507,-5.763747662
"2250","42011","Berks County","Pennsylvania",4835,3939,-1923,1642,896,-281,11.653607075,9.4940141193,-4.63492997,3.9576469114,2.1595929553,-0.677283059
"2251","42013","Blair County","Pennsylvania",1330,1629,-402,19,-299,-383,10.645919131,13.039249823,-3.217789091,0.152084559,-2.393330692,-3.065704532
"2252","42015","Bradford County","Pennsylvania",710,735,-304,26,-25,-278,11.488394295,11.892915221,-4.918974459,0.4207017629,-0.404520926,-4.498272696
"2253","42017","Bucks County","Pennsylvania",5739,5917,-605,862,-178,257,9.177260734,9.4619013353,-0.967458223,1.3784280803,-0.284640601,0.4109698569
"2254","42019","Butler County","Pennsylvania",1815,1946,236,100,-131,336,9.7661767436,10.471063329,1.2698720173,0.5380813633,-0.704886586,1.8079533806
"2255","42021","Cambria County","Pennsylvania",1341,1920,-961,45,-579,-916,9.8044591645,14.037704397,-7.026163503,0.3290086968,-4.233245232,-6.697154806
"2256","42023","Cameron County","Pennsylvania",49,55,-57,7,-6,-50,10.200895181,11.449984386,-11.86634745,1.4572707401,-1.249089206,-10.40907671
"2257","42025","Carbon County","Pennsylvania",576,848,-233,11,-272,-222,8.9969775778,13.245550323,-3.639402388,0.1718172801,-4.248572745,-3.467585108
"2258","42027","Centre County","Pennsylvania",1273,959,-629,1105,314,476,7.9538389926,5.9919336951,-3.930058701,6.9041571774,1.9619052975,2.9740984764
"2259","42029","Chester County","Pennsylvania",5726,3897,-887,1374,1829,487,11.140197025,7.5817931904,-1.7256994,2.673180355,3.5584038351,0.9474809555
"2260","42031","Clarion County","Pennsylvania",408,414,-48,12,-6,-36,10.490049879,10.644315319,-1.234123515,0.3085308788,-0.154265439,-0.925592636
"2261","42033","Clearfield County","Pennsylvania",781,921,-215,57,-140,-158,9.6576540928,11.388859692,-2.65863717,0.704847994,-1.731205599,-1.953789176
"2262","42035","Clinton County","Pennsylvania",447,395,-151,13,52,-138,11.337695937,10.01876934,-3.829959925,0.3297316492,1.3189265967,-3.500228276
"2263","42037","Columbia County","Pennsylvania",599,724,-317,19,-125,-298,8.9517219736,10.819777477,-4.737388757,0.2839444366,-1.868055504,-4.453444321
"2264","42039","Crawford County","Pennsylvania",985,1092,-558,25,-107,-533,11.343940205,12.576226096,-6.426313335,0.2879172641,-1.23228589,-6.138396071
"2265","42041","Cumberland County","Pennsylvania",2539,2295,1617,617,244,2234,10.383035453,9.3852171584,6.6125909129,2.5231716718,0.9978182948,9.1357625847
"2266","42043","Dauphin County","Pennsylvania",3421,2454,-1166,1116,967,-50,12.545404205,8.9992463956,-4.275925549,4.0925668205,3.5461578095,-0.183358729
"2267","42045","Delaware County","Pennsylvania",6823,5449,-2513,1579,1374,-934,12.11998483,9.6792902446,-4.463948685,2.8048447965,2.4406945854,-1.659103889
"2268","42047","Elk County","Pennsylvania",284,401,-176,2,-117,-174,9.1500741027,12.919646884,-5.670468458,0.0644371416,-3.769572782,-5.606031316
"2269","42049","Erie County","Pennsylvania",3166,2924,-1956,458,242,-1498,11.355423685,10.487447522,-7.015542871,1.6426986885,0.8679761629,-5.372844182
"2270","42051","Fayette County","Pennsylvania",1408,1802,-434,75,-394,-359,10.538409434,13.487367755,-3.248344953,0.5613499343,-2.948958322,-2.686995019
"2271","42053","Forest County","Pennsylvania",43,94,-36,3,-51,-33,5.795148248,12.668463612,-4.851752022,0.4043126685,-6.873315364,-4.447439353
"2272","42055","Franklin County","Pennsylvania",1858,1570,20,184,288,204,12.156463765,10.272146453,0.1308553688,1.2038693933,1.8843173112,1.3347247621
"2273","42057","Fulton County","Pennsylvania",118,167,23,0,-49,23,8.1270016185,11.501773477,1.5840765867,0,-3.374771859,1.5840765867
"2274","42059","Greene County","Pennsylvania",402,444,-318,2,-42,-316,10.697748683,11.815423918,-8.462398212,0.0532226303,-1.117675236,-8.409175581
"2275","42061","Huntingdon County","Pennsylvania",405,453,-225,25,-48,-200,8.8794369779,9.9318146938,-4.933020543,0.5481133937,-1.052377716,-4.38490715
"2276","42063","Indiana County","Pennsylvania",794,931,-603,88,-137,-515,9.1161679947,10.68910882,-6.923235895,1.0103561505,-1.572940825,-5.912879745
"2277","42065","Jefferson County","Pennsylvania",516,583,-161,6,-67,-155,11.606590564,13.113647866,-3.621436203,0.1349603554,-1.507057302,-3.486475848
"2278","42067","Juniata County","Pennsylvania",300,269,-109,32,31,-77,12.264170227,10.996872637,-4.455981849,1.3081781575,1.2672975901,-3.147803692
"2279","42069","Lackawanna County","Pennsylvania",2206,2731,-1169,741,-525,-428,10.386993187,12.858965727,-5.504258856,3.4890126706,-2.47197254,-2.015246185
"2280","42071","Lancaster County","Pennsylvania",7189,5055,-977,1315,2134,338,13.449236102,9.4569326051,-1.827779061,2.4601120427,3.9923034974,0.6323329813
"2281","42073","Lawrence County","Pennsylvania",924,1211,-252,29,-287,-223,10.45580048,13.703435477,-2.851581949,0.3281582402,-3.247634998,-2.523423709
"2282","42075","Lebanon County","Pennsylvania",1629,1394,192,561,235,753,11.889860044,10.174625477,1.401383136,4.0946663504,1.7152345675,5.4960494863
"2283","42077","Lehigh County","Pennsylvania",4115,3525,-470,1940,590,1470,11.471774278,9.8269755357,-1.310263405,5.4083212877,1.6447987421,4.098057883
"2284","42079","Luzerne County","Pennsylvania",3215,4158,-1141,930,-943,-211,10.092131904,13.052281324,-3.581686626,2.9193414217,-2.96014942,-0.662345204
"2285","42081","Lycoming County","Pennsylvania",1271,1275,-773,52,-4,-721,10.962614122,10.997114875,-6.66727043,0.4485097831,-0.034500753,-6.218760647
"2286","42083","McKean County","Pennsylvania",443,540,-147,9,-97,-138,10.417401529,12.698412698,-3.456790123,0.2116402116,-2.28101117,-3.245149912
"2287","42085","Mercer County","Pennsylvania",1119,1436,-779,49,-317,-730,9.8023327625,12.579222383,-6.823965346,0.4292353042,-2.776889621,-6.394730042
"2288","42087","Mifflin County","Pennsylvania",592,574,-92,23,18,-69,12.741732402,12.354314863,-1.98013409,0.4950335224,0.3874175393,-1.485100567
"2289","42089","Monroe County","Pennsylvania",1394,1411,-1064,366,-17,-698,8.3495302641,8.4513538039,-6.372955668,2.1922009158,-0.10182354,-4.180754752
"2290","42091","Montgomery County","Pennsylvania",8804,7574,-1987,2315,1230,328,10.780938409,9.2747418802,-2.433180897,2.8348333051,1.5061965293,0.4016524078
"2291","42093","Montour County","Pennsylvania",232,232,-154,29,0,-125,12.639952055,12.639952055,-8.390313002,1.5799940069,0,-6.810318995
"2292","42095","Northampton County","Pennsylvania",2785,3035,146,640,-250,786,9.2872959129,10.120984954,0.4868743997,2.1342439441,-0.833689041,2.6211183438
"2293","42097","Northumberland County","Pennsylvania",971,1192,-491,-2,-221,-493,10.412924466,12.782910364,-5.265443783,-0.021447836,-2.369985898,-5.286891619
"2294","42099","Perry County","Pennsylvania",557,480,101,13,77,114,12.173266894,10.490427485,2.2073607833,0.2841157444,1.682839409,2.4914765277
"2295","42101","Philadelphia County","Pennsylvania",22699,14082,-11796,8904,8617,-2892,14.47242499,8.9783994323,-7.520891898,5.6770109747,5.494025558,-1.843880923
"2296","42103","Pike County","Pennsylvania",368,449,-285,53,-81,-232,6.6300930555,8.08943419,-5.134718807,0.9548775325,-1.459341135,-4.179841274
"2297","42105","Potter County","Pennsylvania",192,199,-101,3,-7,-98,11.203501094,11.611962071,-5.893508388,0.1750547046,-0.408460977,-5.718453683
"2298","42107","Schuylkill County","Pennsylvania",1398,1984,-728,55,-586,-673,9.6573639127,13.705443493,-5.02901354,0.3799392097,-4.04807958,-4.64907433
"2299","42109","Snyder County","Pennsylvania",441,322,151,26,119,177,10.921924339,7.9747384063,3.7397065197,0.6439229769,2.9471859328,4.3836294966
"2300","42111","Somerset County","Pennsylvania",642,1007,-432,43,-365,-389,8.4726190555,13.289606525,-5.701201607,0.5674807156,-4.816987469,-5.133720892
"2301","42113","Sullivan County","Pennsylvania",52,95,28,6,-43,34,8.2908163265,15.146683673,4.4642857143,0.9566326531,-6.855867347,5.4209183673
"2302","42115","Susquehanna County","Pennsylvania",378,433,-252,2,-55,-250,9.0136277467,10.325134429,-6.009085164,0.0476911521,-1.311506683,-5.961394012
"2303","42117","Tioga County","Pennsylvania",455,436,-409,8,19,-401,10.909178095,10.453629999,-9.806272178,0.1918097248,0.4555480963,-9.614462453
"2304","42119","Union County","Pennsylvania",418,353,443,72,65,515,9.2359361881,7.7997260153,9.7883247161,1.5908789606,1.4362101728,11.379203677
"2305","42121","Venango County","Pennsylvania",524,660,-260,0,-136,-260,9.8579625623,12.416517731,-4.89135547,0,-2.558555169,-4.89135547
"2306","42123","Warren County","Pennsylvania",409,509,-238,10,-100,-228,10.101010101,12.570694722,-5.877849399,0.2469684621,-2.469684621,-5.630880937
"2307","42125","Washington County","Pennsylvania",1994,2589,295,115,-595,410,9.5940799619,12.456907232,1.4193849492,0.5533195565,-2.86282727,1.9727045057
"2308","42127","Wayne County","Pennsylvania",423,604,-55,10,-181,-45,8.1458158815,11.63137776,-1.059148637,0.1925724795,-3.485561878,-0.866576158
"2309","42129","Westmoreland County","Pennsylvania",3195,4620,-567,90,-1425,-477,8.9244688265,12.904865721,-1.583778975,0.2513934881,-3.980396894,-1.332385487
"2310","42131","Wyoming County","Pennsylvania",290,312,-340,3,-22,-337,10.362138888,11.148232183,-12.14871456,0.1071945402,-0.786093295,-12.04152002
"2311","42133","York County","Pennsylvania",4957,4146,-70,620,811,550,11.236591801,9.3982064976,-0.158676907,1.40542403,1.8383853038,1.2467471234
"2312","44001","Bristol County","Rhode Island",343,529,154,81,-186,235,6.9865971402,10.775247484,3.1368395323,1.6498961177,-3.788650344,4.78673565
"2313","44003","Kent County","Rhode Island",1612,1758,-677,82,-146,-595,9.8216924141,10.711250164,-4.124867099,0.4996146265,-0.88955775,-3.625252473
"2314","44005","Newport County","Rhode Island",610,679,-333,325,-69,-8,7.3221380643,8.1503799109,-3.997167173,3.9011391326,-0.828241847,-0.09602804
"2315","44007","Providence County","Rhode Island",7449,5854,-4432,3964,1595,-468,11.762263016,9.2436954886,-6.998301743,6.2593113968,2.5185675272,-0.738990347
"2316","44009","Washington County","Rhode Island",862,1251,145,89,-389,234,6.8266953884,9.9074198734,1.1483420317,0.7048444195,-3.080724485,1.8531864511
"2317","45001","Abbeville County","South Carolina",247,318,80,-8,-71,72,9.9697275479,12.835519677,3.229061554,-0.322906155,-2.865792129,2.9061553986
"2318","45003","Aiken County","South Carolina",1928,1679,1019,184,249,1203,11.689453421,10.179767787,6.1781914087,1.1155909904,1.5096856337,7.2937823991
"2319","45005","Allendale County","South Carolina",90,121,-252,1,-31,-251,9.4142259414,12.656903766,-26.35983264,0.1046025105,-3.242677824,-26.25523013
"2320","45007","Anderson County","South Carolina",2299,2058,1567,128,241,1695,11.925820257,10.675658151,8.1286473868,0.6639865128,1.2501621061,8.7926338996
"2321","45009","Bamberg County","South Carolina",136,182,-431,2,-46,-429,9.1137543977,12.196347797,-28.88255989,0.1340258,-3.082593399,-28.74853409
"2322","45011","Barnwell County","South Carolina",246,256,-240,5,-10,-235,11.23082542,11.687363039,-10.95690285,0.2282688093,-0.456537619,-10.72863404
"2323","45013","Beaufort County","South Carolina",2078,1495,3590,555,583,4145,11.711429916,8.4256918789,20.232932338,3.1279324367,3.2857380371,23.360864775
"2324","45015","Berkeley County","South Carolina",2774,1435,2836,595,1339,3431,13.826205494,7.1523449474,14.13522667,2.9656064416,6.6738605467,17.100833111
"2325","45017","Calhoun County","South Carolina",128,181,-36,5,-53,-31,8.6468958995,12.227251233,-2.431939472,0.3377693711,-3.580355333,-2.094170101
"2326","45019","Charleston County","South Carolina",5079,3123,6840,556,1956,7396,13.207422056,8.1210433317,17.786723147,1.4458213552,5.0863787246,19.232544503
"2327","45021","Cherokee County","South Carolina",674,634,132,-13,40,119,11.943049021,11.234262729,2.3389947638,-0.230355545,0.7087862921,2.1086392189
"2328","45023","Chester County","South Carolina",381,410,3,-5,-29,-2,11.754361609,12.64905055,0.0925540284,-0.154256714,-0.894688941,-0.061702686
"2329","45025","Chesterfield County","South Carolina",542,531,-31,18,11,-13,11.742149333,11.503840029,-0.671598947,0.389960679,0.2383093038,-0.281638268
"2330","45027","Clarendon County","South Carolina",343,385,-168,6,-42,-162,10.064701653,11.297114101,-4.929649789,0.1760589211,-1.232412447,-4.753590868
"2331","45029","Colleton County","South Carolina",457,528,0,-12,-71,-12,12.187966716,14.081502027,0,-0.320034137,-1.89353531,-0.320034137
"2332","45031","Darlington County","South Carolina",840,843,-144,20,-3,-124,12.428517529,12.472905092,-2.130603005,0.295917084,-0.044387563,-1.834685921
"2333","45033","Dillon County","South Carolina",406,406,-179,47,0,-132,12.99969582,12.99969582,-5.731392985,1.5048908954,0,-4.226502089
"2334","45035","Dorchester County","South Carolina",1936,1047,2978,162,889,3140,12.836281059,6.9419350561,19.745064563,1.0741102952,5.8943460028,20.819174858
"2335","45037","Edgefield County","South Carolina",204,237,147,12,-33,159,7.638875887,8.8745763981,5.504484095,0.4493456404,-1.235700511,5.9538297354
"2336","45039","Fairfield County","South Carolina",215,301,-83,22,-86,-61,9.3671713321,13.114039865,-3.616163817,0.9585012526,-3.746868533,-2.657662564
"2337","45041","Florence County","South Carolina",1735,1441,-415,81,294,-334,12.503107761,10.384425524,-2.9906569,0.5837185756,2.1186822373,-2.406938324
"2338","45043","Georgetown County","South Carolina",570,710,758,9,-140,767,9.3188264818,11.607661056,12.392404339,0.1471393655,-2.288834574,12.539543704
"2339","45045","Greenville County","South Carolina",6417,4166,5753,1368,2251,7121,13.199684047,8.5694068473,11.833844837,2.8139578894,4.6302771995,14.647802727
"2340","45047","Greenwood County","South Carolina",876,759,54,149,117,203,12.540172213,10.865286198,0.7730243145,2.1329744974,1.6748860147,2.9059988118
"2341","45049","Hampton County","South Carolina",220,226,-463,2,-6,-461,10.893246187,11.19033472,-22.92533175,0.0990295108,-0.297088532,-22.82630224
"2342","45051","Horry County","South Carolina",3092,3203,10794,371,-111,11165,10.1934514,10.559387074,35.584771801,1.2230822993,-0.365935674,36.8078541
"2343","45053","Jasper County","South Carolina",377,243,570,43,134,613,13.936380607,8.9828660148,21.070920282,1.5895606528,4.9535145925,22.660480935
"2344","45055","Kershaw County","South Carolina",718,663,393,14,55,407,11.321617509,10.454362686,6.1969299179,0.2207557732,0.8672548231,6.4176856911
"2345","45057","Lancaster County","South Carolina",1058,889,2558,111,169,2669,12.464068611,10.473116253,30.135243391,1.3076669337,1.9909523585,31.442910325
"2346","45059","Laurens County","South Carolina",730,836,23,56,-106,79,10.978764363,12.572941106,0.3459062744,0.8422065812,-1.594176743,1.1881128557
"2347","45061","Lee County","South Carolina",171,228,-479,0,-57,-479,9.4673901008,12.623186801,-26.51976525,0,-3.1557967,-26.51976525
"2348","45063","Lexington County","South Carolina",3193,2366,2920,573,827,3493,11.419375028,8.4617104028,10.443023828,2.0492646073,2.9576646252,12.492288435
"2349","45065","McCormick County","South Carolina",83,131,-99,-3,-48,-102,8.5246238381,13.454526781,-10.16792482,-0.308118934,-4.929902943,-10.47604375
"2350","45067","Marion County","South Carolina",391,445,-160,28,-54,-132,12.272056746,13.966918804,-5.021813502,0.8788173629,-1.694862057,-4.142996139
"2351","45069","Marlboro County","South Carolina",301,362,-396,9,-61,-387,10.828896244,13.023456612,-14.24665419,0.3237875953,-2.194560368,-13.9228666
"2352","45071","Newberry County","South Carolina",445,447,98,15,-2,113,11.796673073,11.849691828,2.5979190139,0.3976406654,-0.053018755,2.9955596792
"2353","45073","Oconee County","South Carolina",823,876,572,156,-53,728,10.893520142,11.595046956,7.5711950443,2.0648713757,-0.701526814,9.63606642
"2354","45075","Orangeburg County","South Carolina",995,1061,-879,69,-66,-810,11.104229093,11.840791023,-9.809665701,0.7700420175,-0.73656193,-9.039623684
"2355","45077","Pickens County","South Carolina",1288,1201,626,272,87,898,10.641857698,9.9230365649,5.1722072353,2.2473488307,0.7188211333,7.419556066
"2356","45079","Richland County","South Carolina",4912,3031,2579,1167,1881,3746,12.183249768,7.5177992765,6.3967021887,2.8945139412,4.6654504913,9.2912161299
"2357","45081","Saluda County","South Carolina",277,241,-8,74,36,66,13.755772955,11.968019069,-0.397278641,3.6748274321,1.7877538859,3.2775487908
"2358","45083","Spartanburg County","South Carolina",3569,3093,2833,184,476,3017,12.105363127,10.490862469,9.6089923616,0.6240926913,1.614500658,10.233085053
"2359","45085","Sumter County","South Carolina",1496,1155,-1014,185,341,-829,13.927550669,10.752888384,-9.440198114,1.7223241135,3.1746622848,-7.717874
"2360","45087","Union County","South Carolina",317,385,-112,0,-68,-112,11.391813706,13.835483523,-4.024867934,0,-2.443669817,-4.024867934
"2361","45089","Williamsburg County","South Carolina",350,420,-198,39,-70,-159,10.725668056,12.870801667,-6.067663643,1.1951458691,-2.145133611,-4.872517774
"2362","45091","York County","South Carolina",2870,2077,5075,154,793,5229,11.593875041,8.390410613,20.501364401,0.622110368,3.2034644276,21.123474769
"2363","46003","Aurora County","South Dakota",45,23,-32,7,22,-25,16.414371694,8.3895677549,-11.67244209,2.553346708,8.0248039394,-9.119095386
"2364","46005","Beadle County","South Dakota",348,196,-296,204,152,-92,19.238742848,10.835613788,-16.36398817,11.277883738,8.4031290599,-5.086104431
"2365","46007","Bennett County","South Dakota",54,38,-51,0,16,-51,15.798712697,11.117612639,-14.92100644,0,4.6811000585,-14.92100644
"2366","46009","Bon Homme County","South Dakota",62,72,-26,3,-10,-23,8.9022901859,10.338143442,-3.733218465,0.4307559767,-1.435853256,-3.302462488
"2367","46011","Brookings County","South Dakota",443,195,145,158,248,303,13.215201957,5.8170753535,4.3255175706,4.7133225941,7.3981266034,9.0388401647
"2368","46013","Brown County","South Dakota",483,400,-4,86,83,82,12.600931373,10.435553932,-0.104355539,2.2436440954,2.1653774409,2.1392885561
"2369","46015","Brule County","South Dakota",79,56,-60,0,23,-60,15.023295617,10.649424741,-11.41009794,0,4.3738708757,-11.41009794
"2370","46017","Buffalo County","South Dakota",51,20,-21,0,31,-21,24.384413101,9.5625149414,-10.04064069,0,14.821898159,-10.04064069
"2371","46019","Butte County","South Dakota",119,105,-49,-4,14,-53,11.640418664,10.270957645,-4.793113567,-0.391274577,1.3694610193,-5.184388144
"2372","46021","Campbell County","South Dakota",18,14,7,1,4,8,12.793176972,9.9502487562,4.9751243781,0.710732054,2.8429282161,5.6858564321
"2373","46023","Charles Mix County","South Dakota",183,113,54,0,70,54,19.680593644,12.152497715,5.8073882884,0,7.5280959295,5.8073882884
"2374","46025","Clark County","South Dakota",67,35,-33,5,32,-28,18.353650185,9.5877277085,-9.039857554,1.3696753869,8.7659224764,-7.670182167
"2375","46027","Clay County","South Dakota",128,111,-149,13,17,-136,9.2602640622,8.0303852415,-10.77952613,0.9404955688,1.2298788208,-9.839030566
"2376","46029","Codington County","South Dakota",366,237,-197,4,129,-193,13.110056416,8.4892988269,-7.056505776,0.1432793051,4.6207575893,-6.913226471
"2377","46031","Corson County","South Dakota",91,35,-57,1,56,-56,21.796407186,8.3832335329,-13.65269461,0.2395209581,13.413173653,-13.41317365
"2378","46033","Custer County","South Dakota",72,92,36,-3,-20,33,8.5338390423,10.904349887,4.2669195212,-0.355576627,-2.370510845,3.9113428944
"2379","46035","Davison County","South Dakota",240,243,-44,-8,-3,-52,12.038523274,12.189004815,-2.2070626,-0.401284109,-0.150481541,-2.608346709
"2380","46037","Day County","South Dakota",68,71,-5,4,-3,-1,12.367009184,12.912612531,-0.909338911,0.7274711285,-0.545603346,-0.181867782
"2381","46039","Deuel County","South Dakota",47,48,3,3,-1,6,10.873337189,11.104684789,0.6940427993,0.6940427993,-0.2313476,1.3880855986
"2382","46041","Dewey County","South Dakota",153,68,-46,1,85,-45,26.943735141,11.974993396,-8.100730827,0.1761028441,14.968741745,-7.924627983
"2383","46043","Douglas County","South Dakota",45,48,21,4,-3,25,15.313935681,16.334864727,7.146503318,1.3612387272,-1.020929045,8.5077420453
"2384","46045","Edmunds County","South Dakota",52,39,7,6,13,13,13.06040437,9.7953032777,1.7581313575,1.506969735,3.2651010926,3.2651010926
"2385","46047","Fall River County","South Dakota",74,125,4,-1,-51,3,10.849644454,18.327102119,0.5864672678,-0.146616817,-7.477457664,0.4398504508
"2386","46049","Faulk County","South Dakota",31,36,-8,0,-5,-8,13.399610979,15.560838556,-3.457964124,0,-2.161227577,-3.457964124
"2387","46051","Grant County","South Dakota",92,82,-104,0,10,-104,12.661712084,11.285439031,-14.31323975,0,1.3762730526,-14.31323975
"2388","46053","Gregory County","South Dakota",54,70,-17,0,-16,-17,12.829650748,16.631028748,-4.038964124,0,-3.801378,-4.038964124
"2389","46055","Haakon County","South Dakota",23,27,8,0,-4,8,12.445887446,14.61038961,4.329004329,0,-2.164502165,4.329004329
"2390","46057","Hamlin County","South Dakota",118,64,-31,1,54,-30,19.762183889,10.718472618,-5.191760174,0.1674761347,9.0437112711,-5.02428404
"2391","46059","Hand County","South Dakota",31,43,-22,0,-12,-22,9.3289196509,12.940114354,-6.620523623,0,-3.611194704,-6.620523623
"2392","46061","Hanson County","South Dakota",37,33,-38,0,4,-38,10.863182619,9.6887844979,-11.15678215,0,1.174398121,-11.15678215
"2393","46063","Harding County","South Dakota",23,7,8,0,16,8,18.304814962,5.5710306407,6.3668921608,0,12.733784322,6.3668921608
"2394","46065","Hughes County","South Dakota",234,142,-162,-3,92,-165,13.304904051,8.0739161336,-9.21108742,-0.170575693,5.2309879176,-9.381663113
"2395","46067","Hutchinson County","South Dakota",115,119,42,6,-4,48,15.869730215,16.421720831,5.7959014697,0.8279859242,-0.551990616,6.6238873939
"2396","46069","Hyde County","South Dakota",17,20,-3,0,-3,-3,12.234616769,14.393666787,-2.159050018,0,-2.159050018,-2.159050018
"2397","46071","Jackson County","South Dakota",73,46,-18,5,27,-13,22.327573023,14.069429576,-5.505428965,1.5292858235,8.258143447,-3.976143141
"2398","46073","Jerauld County","South Dakota",21,32,-15,6,-11,-9,10.342280227,15.759665107,-7.387343019,2.9549372076,-5.417384881,-4.432405811
"2399","46075","Jones County","South Dakota",12,11,-41,0,1,-41,12.813667912,11.745862253,-43.78003203,0,1.0678056594,-43.78003203
"2400","46077","Kingsbury County","South Dakota",73,73,-100,0,0,-100,14.591245253,14.591245253,-19.9880072,0,0,-19.9880072
"2401","46079","Lake County","South Dakota",127,110,229,-5,17,224,10.400458603,9.0082712309,18.753582835,-0.409466874,1.392187372,18.344115961
"2402","46081","Lawrence County","South Dakota",216,235,88,29,-19,117,8.717762441,9.4846026557,3.5516809945,1.1704403277,-0.766840215,4.7221213222
"2403","46083","Lincoln County","South Dakota",772,211,815,2,561,817,14.769748799,4.0368095812,15.592416155,0.0382635979,10.732939218,15.630679753
"2404","46085","Lyman County","South Dakota",64,36,-6,0,28,-6,16.541742052,9.3047299044,-1.550788317,0,7.2370121478,-1.550788317
"2405","46087","McCook County","South Dakota",77,92,-59,0,-15,-59,13.973323655,16.695399691,-10.70683241,0,-2.722076037,-10.70683241
"2406","46089","McPherson County","South Dakota",26,42,-3,-2,-16,-5,10.799584631,17.445482866,-1.246105919,-0.830737279,-6.645898235,-2.076843198
"2407","46091","Marshall County","South Dakota",63,49,51,20,14,71,13.203395159,10.269307346,10.688462748,4.1915540187,2.9340878131,14.880016766
"2408","46093","Meade County","South Dakota",307,197,-115,58,110,-57,11.478351903,7.3655873776,-4.299708368,2.168548568,4.1127645255,-2.1311598
"2409","46095","Mellette County","South Dakota",49,25,-65,0,24,-65,23.960880196,12.224938875,-31.78484108,0,11.73594132,-31.78484108
"2410","46097","Miner County","South Dakota",28,31,-71,0,-3,-71,12.474938739,13.811539318,-31.63288037,0,-1.336600579,-31.63288037
"2411","46099","Minnehaha County","South Dakota",2973,1376,263,810,1597,1073,16.320951259,7.5538610606,1.4437975719,4.4466769325,8.7670901989,5.8904745043
"2412","46101","Moody County","South Dakota",90,50,-34,11,40,-23,13.968648145,7.7603600807,-5.277044855,1.7072792178,6.2082880646,-3.569765637
"2413","46102","Oglala Lakota County","South Dakota",328,143,-33,-3,185,-36,22.958737269,10.00944948,-2.309872957,-0.209988451,12.949287789,-2.519861408
"2414","46103","Pennington County","South Dakota",1562,839,-213,64,723,-149,14.491409062,7.7837978254,-1.976101236,0.5937581178,6.7076112369,-1.382343118
"2415","46105","Perkins County","South Dakota",34,48,-24,0,-14,-24,11.354149274,16.02938721,-8.014693605,0,-4.675237936,-8.014693605
"2416","46107","Potter County","South Dakota",18,38,8,0,-20,8,7.8328981723,16.536118364,3.4812880766,0,-8.703220191,3.4812880766
"2417","46109","Roberts County","South Dakota",174,130,-128,9,44,-119,16.990528269,12.694072844,-12.49877942,0.8788204277,4.2964554243,-11.61995899
"2418","46111","Sanborn County","South Dakota",38,27,3,3,11,6,16.24278692,11.540927549,1.2823252832,1.2823252832,4.7018593717,2.5646505664
"2419","46115","Spink County","South Dakota",67,75,-93,0,-8,-93,10.14459838,11.355893709,-14.0813082,0,-1.211295329,-14.0813082
"2420","46117","Stanley County","South Dakota",38,21,-22,0,17,-22,12.762384551,7.0528967254,-7.38874895,0,5.7094878254,-7.38874895
"2421","46119","Sully County","South Dakota",14,7,-11,1,7,-10,9.9750623441,4.9875311721,-7.837548985,0.7125044532,4.9875311721,-7.125044532
"2422","46121","Todd County","South Dakota",261,92,-109,31,169,-78,26.131357629,9.2110532639,-10.91309571,3.1037244694,16.920304365,-7.809371245
"2423","46123","Tripp County","South Dakota",69,62,-93,-3,7,-96,12.631578947,11.350114416,-17.02517162,-0.549199085,1.2814645309,-17.57437071
"2424","46125","Turner County","South Dakota",92,131,-23,5,-39,-18,11.272437665,16.050971022,-2.818109416,0.6126324818,-4.778533358,-2.205476934
"2425","46127","Union County","South Dakota",146,131,-125,40,15,-85,9.7639269712,8.7607837892,-8.359526516,2.6750484853,1.003143182,-5.684478031
"2426","46129","Walworth County","South Dakota",78,108,-94,26,-30,-68,14.301430143,19.801980198,-17.23505684,4.767143381,-5.500550055,-12.46791346
"2427","46135","Yankton County","South Dakota",269,241,-31,14,28,-17,11.860931678,10.626336559,-1.366873167,0.6172975595,1.2345951189,-0.749575608
"2428","46137","Ziebach County","South Dakota",33,17,-37,1,16,-36,11.58504476,5.9680533614,-12.98929261,0.3510619624,5.616991399,-12.63823065
"2429","47001","Anderson County","Tennessee",816,949,406,78,-133,484,10.834926705,12.600913533,5.3909071595,1.0356915233,-1.765986828,6.4265986828
"2430","47003","Bedford County","Tennessee",627,490,450,47,137,497,13.453492115,10.513893359,9.6556163502,1.0084754855,2.9395987555,10.664091836
"2431","47005","Benton County","Tennessee",169,254,98,-1,-85,97,10.445962234,15.699848564,6.0574218871,-0.061810427,-5.253886331,5.9956114597
"2432","47007","Bledsoe County","Tennessee",139,141,73,0,-2,73,9.6167150962,9.7550850976,5.0505050505,0,-0.138370001,5.0505050505
"2433","47009","Blount County","Tennessee",1296,1353,1016,75,-57,1091,10.256897289,10.708010827,8.0409009608,0.5935704449,-0.451113538,8.6344714057
"2434","47011","Bradley County","Tennessee",1203,1086,728,79,117,807,11.650823935,10.517701408,7.0505401702,0.7650998262,1.1331225273,7.8156399963
"2435","47013","Campbell County","Tennessee",417,590,-21,-7,-173,-28,10.480810315,14.828964235,-0.527810591,-0.175936864,-4.34815392,-0.703747455
"2436","47015","Cannon County","Tennessee",167,193,153,4,-26,157,12.209833668,14.110765856,11.186254798,0.2924511058,-1.900932188,11.478705904
"2437","47017","Carroll County","Tennessee",291,481,-221,8,-190,-213,10.330505165,17.075508538,-7.845503923,0.284000142,-6.745003373,-7.561503781
"2438","47019","Carter County","Tennessee",531,693,261,0,-162,261,9.4269279932,12.302939923,4.6335747763,0,-2.87601193,4.6335747763
"2439","47021","Cheatham County","Tennessee",463,385,-110,-2,78,-112,11.694281673,9.7241867044,-2.778339058,-0.050515256,1.9700949687,-2.828854314
"2440","47023","Chester County","Tennessee",196,205,-16,18,-9,2,11.455958852,11.981997779,-0.935180314,1.0520778538,-0.526038927,0.1168975393
"2441","47025","Claiborne County","Tennessee",326,431,95,7,-105,102,10.336736635,13.66605365,3.0122392035,0.2219544676,-3.329317014,3.2341936711
"2442","47027","Clay County","Tennessee",84,107,62,7,-23,69,10.954616588,13.95409494,8.0855503391,0.9128847157,-2.999478352,8.9984350548
"2443","47029","Cocke County","Tennessee",414,521,-18,-6,-107,-24,11.782619214,14.827885532,-0.512287792,-0.170762597,-3.045266319,-0.683050389
"2444","47031","Coffee County","Tennessee",727,655,517,-19,72,498,13.511253183,12.173137324,9.608415262,-0.353113907,1.3381158585,9.2553013548
"2445","47033","Crockett County","Tennessee",164,182,-54,12,-18,-42,11.215592409,12.446572064,-3.692938964,0.8206531031,-1.230979655,-2.872285861
"2446","47035","Cumberland County","Tennessee",573,834,517,29,-261,546,9.8803324482,14.380798014,8.9147153154,0.5000517295,-4.500465565,9.4147670449
"2447","47037","Davidson County","Tennessee",10357,5144,1749,3655,5213,5404,15.331620116,7.6147391981,2.58907054,5.4105504995,7.7168809176,7.9996210394
"2448","47039","Decatur County","Tennessee",127,189,-30,7,-62,-23,10.911590343,16.238508463,-2.577541026,0.6014262394,-5.32691812,-1.976114786
"2449","47041","DeKalb County","Tennessee",254,242,-21,69,12,48,13.174615524,12.552192744,-1.089239866,3.5789309889,0.6224227807,2.4896911227
"2450","47043","Dickson County","Tennessee",630,514,734,-1,116,733,12.377210216,10.098231827,14.42043222,-0.019646365,2.278978389,14.400785855
"2451","47045","Dyer County","Tennessee",445,427,-70,17,18,-53,11.774667266,11.29838859,-1.852194851,0.4498187495,0.4762786759,-1.402376101
"2452","47047","Fayette County","Tennessee",417,409,152,32,8,184,10.655287399,10.450869415,3.8839416898,0.8176719347,0.2044179837,4.7016136245
"2453","47049","Fentress County","Tennessee",176,240,87,-1,-64,86,9.8607726139,13.44650811,4.8743591898,-0.056027117,-3.585735496,4.8183320727
"2454","47051","Franklin County","Tennessee",399,490,101,43,-91,144,9.6619527315,11.865555986,2.4457574583,1.0412630763,-2.203603255,3.4870205347
"2455","47053","Gibson County","Tennessee",634,681,-123,12,-47,-111,12.861344964,13.814788518,-2.495182067,0.2434323968,-0.953443554,-2.25174967
"2456","47055","Giles County","Tennessee",344,332,86,48,12,134,11.904967902,11.489678324,2.9762419754,1.6611583118,0.415289578,4.6374002872
"2457","47057","Grainger County","Tennessee",222,284,48,0,-62,48,9.7144732524,12.427524341,2.1004266492,0,-2.713051089,2.1004266492
"2458","47059","Greene County","Tennessee",636,878,299,4,-242,303,9.28548486,12.818641049,4.3653458697,0.0583992758,-3.533156189,4.4237451456
"2459","47061","Grundy County","Tennessee",158,205,8,1,-47,9,11.831217942,15.350630873,0.5990490097,0.0748811262,-3.519412932,0.6739301359
"2460","47063","Hamblen County","Tennessee",803,752,262,92,51,354,12.710321794,11.903065989,4.147078842,1.4562261583,0.8072558051,5.6033050002
"2461","47065","Hamilton County","Tennessee",4223,3479,1920,428,744,2348,11.989461312,9.877181128,5.4510456355,1.2151289229,2.1122801837,6.6661745584
"2462","47067","Hancock County","Tennessee",67,123,12,1,-56,13,10.149208513,18.632129062,1.8177686889,0.1514807241,-8.482920548,1.969249413
"2463","47069","Hardeman County","Tennessee",289,287,-147,-2,2,-149,11.177289604,11.099938119,-5.685334158,-0.077351485,0.0773514851,-5.762685644
"2464","47071","Hardin County","Tennessee",284,389,38,22,-105,60,11.017146404,15.090387152,1.4741252231,0.8534409186,-4.073240748,2.3275661417
"2465","47073","Hawkins County","Tennessee",558,731,58,-1,-173,57,9.9091659785,12.981362599,1.0299849942,-0.017758362,-3.072196621,1.0122266322
"2466","47075","Haywood County","Tennessee",207,188,-216,7,19,-209,11.449748327,10.398805244,-11.94756347,0.3871895569,1.0509430831,-11.56037391
"2467","47077","Henderson County","Tennessee",316,342,12,-2,-26,10,11.293983095,12.223234868,0.428885434,-0.071480906,-0.929251774,0.3574045283
"2468","47079","Henry County","Tennessee",341,453,6,7,-112,13,10.594503907,14.074223665,0.1864135585,0.2174824849,-3.479719758,0.4038960434
"2469","47081","Hickman County","Tennessee",298,294,-67,0,4,-67,12.207861371,12.04399746,-2.74472051,0,0.163863911,-2.74472051
"2470","47083","Houston County","Tennessee",101,97,-101,0,4,-101,12.360788153,11.871251989,-12.36078815,0,0.4895361645,-12.36078815
"2471","47085","Humphreys County","Tennessee",203,232,29,-2,-29,27,11.187963295,12.786243765,1.5982804707,-0.110226239,-1.598280471,1.4880542313
"2472","47087","Jackson County","Tennessee",102,179,82,0,-77,82,8.8514774157,15.533475073,7.1158936087,0,-6.681997657,7.1158936087
"2473","47089","Jefferson County","Tennessee",540,575,594,28,-35,622,10.249693933,10.914025947,11.274663326,0.5314656113,-0.664332014,11.806128937
"2474","47091","Johnson County","Tennessee",169,217,-45,-4,-48,-49,9.4505801761,12.134768629,-2.516426674,-0.223682371,-2.684188452,-2.740109045
"2475","47093","Knox County","Tennessee",5343,4514,1890,576,829,2466,11.885839878,10.041677187,4.2044239884,1.2813482631,1.8441626912,5.4857722515
"2476","47095","Lake County","Tennessee",70,104,-64,1,-34,-63,9.184543725,13.64560782,-8.39729712,0.1312077675,-4.461064095,-8.266089352
"2477","47097","Lauderdale County","Tennessee",289,275,-459,1,14,-458,10.650451446,10.134512622,-16.91542289,0.0368527732,0.5159388244,-16.87857011
"2478","47099","Lawrence County","Tennessee",571,543,199,15,28,214,13.48909179,12.827630196,4.7011020423,0.3543544253,0.6614615939,5.0554564676
"2479","47101","Lewis County","Tennessee",142,135,-19,-1,7,-20,11.942306884,11.353601615,-1.597914301,-0.084100753,0.5887052689,-1.682015054
"2480","47103","Lincoln County","Tennessee",356,407,206,14,-51,220,10.619099465,12.14037495,6.1447598025,0.4176050351,-1.521275485,6.5623648377
"2481","47105","Loudon County","Tennessee",532,645,420,37,-113,457,10.485444547,12.71261604,8.2779825374,0.7292508426,-2.227171492,9.00723338
"2482","47107","McMinn County","Tennessee",574,672,-49,69,-98,20,10.930834857,12.797074954,-0.933120049,1.3139853748,-1.866240098,0.380865326
"2483","47109","McNairy County","Tennessee",265,381,-44,-1,-116,-45,10.213520388,14.684344408,-1.6958298,-0.038541586,-4.470824019,-1.734371387
"2484","47111","Macon County","Tennessee",344,265,50,8,79,58,14.966607931,11.529509017,2.1753790598,0.3480606496,3.4370989145,2.5234397094
"2485","47113","Madison County","Tennessee",1222,1009,-810,68,213,-742,12.489651578,10.312650116,-8.278737952,0.6950051614,2.1770014616,-7.583732791
"2486","47115","Marion County","Tennessee",353,386,60,3,-33,63,12.442501895,13.605681958,2.1148728433,0.1057436422,-1.163180064,2.2206164854
"2487","47117","Marshall County","Tennessee",407,334,206,24,73,230,12.964880147,10.639483953,6.5620769292,0.764513817,2.3253961934,7.3265907462
"2488","47119","Maury County","Tennessee",1136,940,1758,56,196,1814,13.150050644,10.881203878,20.350166401,0.6482419332,2.268846766,20.998408335
"2489","47121","Meigs County","Tennessee",126,148,112,-1,-22,111,10.727512664,12.600570431,9.5355668128,-0.085138989,-1.873057767,9.4504278234
"2490","47123","Monroe County","Tennessee",494,548,300,20,-54,320,10.851538217,12.03773875,6.5900029655,0.439333531,-1.186200534,7.0293364965
"2491","47125","Montgomery County","Tennessee",3447,1175,439,799,2272,1238,18.073947456,6.1609771572,2.3018459336,4.1894644669,11.912970299,6.4913104005
"2492","47127","Moore County","Tennessee",48,71,-17,-1,-23,-18,7.6487929249,11.313839535,-2.708947494,-0.159349853,-3.66504661,-2.868297347
"2493","47129","Morgan County","Tennessee",228,242,-189,0,-14,-189,10.562646221,11.211229761,-8.755877788,0,-0.64858354,-8.755877788
"2494","47131","Obion County","Tennessee",334,373,-212,4,-39,-208,10.880187634,12.150628705,-6.905987361,0.1303016483,-1.270441071,-6.775685712
"2495","47133","Overton County","Tennessee",220,278,175,1,-58,176,9.9986365496,12.634640731,7.9534608917,0.045448348,-2.636004181,7.9989092396
"2496","47135","Perry County","Tennessee",100,132,59,3,-32,62,12.767315672,16.852856687,7.5327162464,0.3830194702,-4.085541015,7.9157357166
"2497","47137","Pickett County","Tennessee",47,74,89,-3,-27,86,9.2093661213,14.499853042,17.439012442,-0.58783188,-5.290486921,16.851180562
"2498","47139","Polk County","Tennessee",183,227,129,0,-44,129,10.939414771,13.569656574,7.7113907404,0,-2.630241803,7.7113907404
"2499","47141","Putnam County","Tennessee",857,856,-166,299,1,133,11.425371791,11.412039969,-2.213082517,3.9862148956,0.0133318224,1.7731323783
"2500","47143","Rhea County","Tennessee",378,436,-177,51,-58,-126,11.643308178,13.429847528,-5.452025258,1.570922532,-1.78653935,-3.881102726
"2501","47145","Roane County","Tennessee",441,714,195,-10,-273,185,8.3561501075,13.529004936,3.6948963061,-0.189481862,-5.172854828,3.5054144442
"2502","47147","Robertson County","Tennessee",885,676,297,63,209,360,12.979394295,9.9142040038,4.3557967295,0.923956882,3.0651902911,5.2797536115
"2503","47149","Rutherford County","Tennessee",3978,1816,6374,614,2162,6988,13.561702679,6.1910638675,21.730088707,2.093234149,7.3706388114,23.823322856
"2504","47151","Scott County","Tennessee",255,290,-62,0,-35,-62,11.623401782,13.218770654,-2.826082002,0,-1.595368872,-2.826082002
"2505","47153","Sequatchie County","Tennessee",166,170,4,-1,-4,3,11.341509241,11.61479862,0.2732893793,-0.068322345,-0.273289379,0.2049670345
"2506","47155","Sevier County","Tennessee",1031,1062,732,172,-31,904,10.858460858,11.184951922,7.7094018894,1.8114988046,-0.326491064,9.5209006941
"2507","47157","Shelby County","Tennessee",13695,8051,-7729,1444,5644,-6285,14.596097369,8.5807360291,-8.23754922,1.539011654,6.01536134,-6.698537566
"2508","47159","Smith County","Tennessee",208,204,196,0,4,196,10.874679772,10.665551315,10.247294401,0,0.2091284572,10.247294401
"2509","47161","Stewart County","Tennessee",123,174,32,-1,-51,31,9.3128904032,13.174332765,2.4228657959,-0.075714556,-3.861442362,2.3471512398
"2510","47163","Sullivan County","Tennessee",1530,2057,362,-8,-527,354,9.7821708747,13.151585287,2.3144744161,-0.051148606,-3.369414412,2.2633258102
"2511","47165","Sumner County","Tennessee",2128,1468,2244,85,660,2329,12.24783447,8.4491640047,12.915479582,0.4892227114,3.7986704653,13.404702294
"2512","47167","Tipton County","Tennessee",724,597,-199,15,127,-184,11.76002404,9.6971468947,-3.232382298,0.2436469069,2.0628771451,-2.988735391
"2513","47169","Trousdale County","Tennessee",115,110,40,3,5,43,14.337364418,13.714000748,4.9869093629,0.3740182022,0.6233636704,5.3609275651
"2514","47171","Unicoi County","Tennessee",156,294,11,0,-138,11,8.7370484458,16.465975917,0.6160739289,0,-7.728927471,0.6160739289
"2515","47173","Union County","Tennessee",207,208,164,8,-1,172,10.852753821,10.905182583,8.5983170367,0.4194300994,-0.052428762,9.0177471361
"2516","47175","Van Buren County","Tennessee",66,78,52,-1,-12,51,11.633030757,13.748127258,9.1654181722,-0.176258042,-2.115096501,8.9891601304
"2517","47177","Warren County","Tennessee",455,481,261,46,-26,307,11.338151009,11.986045353,6.503862447,1.1462746075,-0.647894343,7.6501370546
"2518","47179","Washington County","Tennessee",1318,1434,333,157,-116,490,10.465757993,11.386871747,2.6442317236,1.2466798217,-0.921113754,3.8909115453
"2519","47181","Wayne County","Tennessee",143,224,-27,2,-81,-25,8.5452209507,13.38552093,-1.613433326,0.1195135797,-4.840299979,-1.493919747
"2520","47183","Weakley County","Tennessee",353,386,-137,29,-33,-108,10.407299851,11.380220234,-4.03909371,0.8549906393,-0.972920383,-3.184103071
"2521","47185","White County","Tennessee",298,340,174,3,-42,177,11.330583069,12.927510884,6.6158438053,0.1140662725,-1.596927815,6.7299100778
"2522","47187","Williamson County","Tennessee",2221,1099,4642,468,1122,5110,10.657849907,5.2737402287,22.27543416,2.2457783685,5.3841096784,24.521212528
"2523","47189","Wilson County","Tennessee",1414,1078,2827,132,336,2959,11.146057496,8.4974893781,22.284232349,1.0405089034,2.6485681179,23.324741252
"2524","48001","Anderson County","Texas",581,616,-220,56,-35,-164,10.061041604,10.667128447,-3.809688731,0.9697389497,-0.606086844,-2.839949781
"2525","48003","Andrews County","Texas",345,128,376,41,217,417,19.421301509,7.2055843279,21.166403963,2.30803873,12.215717181,23.474442693
"2526","48005","Angelina County","Texas",1200,898,-93,77,302,-16,13.677317878,10.235192879,-1.059992136,0.8776278972,3.4421249993,-0.182364238
"2527","48007","Aransas County","Texas",247,371,360,5,-124,365,10.00303736,15.024805103,14.579325706,0.2024906348,-5.021767743,14.781816341
"2528","48009","Archer County","Texas",96,77,-101,2,19,-99,10.912190963,8.7524865018,-11.48053424,0.2273373117,2.1597044615,-11.25319693
"2529","48011","Armstrong County","Texas",19,28,-4,0,-9,-4,9.9632931306,14.682747771,-2.097535396,0,-4.719454641,-2.097535396
"2530","48013","Atascosa County","Texas",749,407,290,10,342,300,15.594907191,8.4741351489,6.0380815557,0.2082097088,7.1207720416,6.2462912646
"2531","48015","Austin County","Texas",372,288,389,27,84,416,12.729917016,9.8554196253,13.311660536,0.9239455899,2.8744973907,14.235606125
"2532","48017","Bailey County","Texas",130,59,146,33,71,179,18.320180383,8.3145434047,20.574971815,4.6505073281,10.005636979,25.225479143
"2533","48019","Bandera County","Texas",163,215,374,8,-52,382,7.7685635306,10.246878277,17.824802211,0.3812791917,-2.478314746,18.206081403
"2534","48021","Bastrop County","Texas",1031,649,1857,25,382,1882,13.027957669,8.200916127,23.465487285,0.3159058601,4.8270415416,23.781393145
"2535","48023","Baylor County","Texas",41,63,64,0,-22,64,11.426978818,17.558528428,17.837235229,0,-6.13154961,17.837235229
"2536","48025","Bee County","Texas",412,269,-384,3,143,-381,12.58822451,8.2190106633,-11.73271411,0.091661829,4.369213847,-11.64105228
"2537","48027","Bell County","Texas",6375,2200,-58,1890,4175,1832,19.133169864,6.6028194039,-0.17407433,5.6724221242,12.53035046,5.4983477945
"2538","48029","Bexar County","Texas",28139,12963,15473,6638,15176,22111,14.987870526,6.9045725016,8.2414911916,3.5356439301,8.0832980239,11.777135122
"2539","48031","Blanco County","Texas",105,124,224,18,-19,242,9.6070268539,11.345441237,20.494990622,1.6469188892,-1.738414383,22.141909511
"2540","48033","Borden County","Texas",5,7,-9,0,-2,-9,7.5757575758,10.606060606,-13.63636364,0,-3.03030303,-13.63636364
"2541","48035","Bosque County","Texas",175,230,197,6,-55,203,9.8350521258,12.926068508,11.071458679,0.3372017872,-3.091016382,11.408660466
"2542","48037","Bowie County","Texas",1220,1035,-301,115,185,-186,13.048407453,11.069755503,-3.219320199,1.2299728336,1.9786519498,-1.989347366
"2543","48039","Brazoria County","Texas",4881,2147,4396,757,2734,5153,14.286236948,6.2840710361,12.866686667,2.2156692009,8.0021659118,15.082355868
"2544","48041","Brazos County","Texas",2896,1079,3785,1747,1817,5532,13.612860769,5.0719187741,17.791670584,8.211901852,8.5409419949,26.003572436
"2545","48043","Brewster County","Texas",104,69,-51,1,35,-50,11.374200252,7.5463443977,-5.577732816,0.1093673101,3.8278558539,-5.468365506
"2546","48045","Briscoe County","Texas",13,19,-32,2,-6,-30,8.4801043705,12.393998695,-20.87410307,1.3046314416,-3.913894325,-19.56947162
"2547","48047","Brooks County","Texas",116,89,-109,47,27,-62,16.073160593,12.331993903,-15.10322849,6.5124012748,3.7411666898,-8.590827214
"2548","48049","Brown County","Texas",390,484,252,39,-94,291,10.35801551,12.854562839,6.6928715606,1.035801551,-2.496547328,7.7286731117
"2549","48051","Burleson County","Texas",207,210,185,42,-3,227,11.827219746,11.998628728,10.570220546,2.3997257456,-0.171408982,12.969946292
"2550","48053","Burnet County","Texas",485,538,839,6,-53,845,10.93524531,12.13023088,18.916847042,0.1352813853,-1.19498557,19.052128427
"2551","48055","Caldwell County","Texas",530,335,484,40,195,524,13.223058019,8.3579706348,12.07539638,0.997966643,4.8650873845,13.073363023
"2552","48057","Calhoun County","Texas",316,207,-73,53,109,-20,14.453312599,9.4678345187,-3.338898164,2.4241315434,4.9854780799,-0.91476662
"2553","48059","Callahan County","Texas",153,168,92,9,-15,101,11.292763036,12.399896668,6.7904196036,0.6642801786,-1.107133631,7.4546997823
"2554","48061","Cameron County","Texas",7250,2650,-4870,825,4600,-4045,17.271671481,6.3130937137,-11.60179864,1.9653970996,10.958577767,-9.636401537
"2555","48063","Camp County","Texas",202,145,-60,47,57,-13,15.923064796,11.429922749,-4.729623207,3.7048715119,4.4931420464,-1.024751695
"2556","48065","Carson County","Texas",56,59,-23,2,-3,-21,9.2961487384,9.7941567065,-3.818061089,0.3320053121,-0.498007968,-3.486055777
"2557","48067","Cass County","Texas",363,373,20,15,-10,35,12.04739305,12.379277156,0.6637682121,0.4978261591,-0.331884106,1.1615943712
"2558","48069","Castro County","Texas",121,74,-226,46,47,-180,15.388528551,9.4111662215,-28.74221035,5.850184408,5.9773623299,-22.89202594
"2559","48071","Chambers County","Texas",496,296,461,116,200,577,12.823495954,7.6527314563,11.918612167,2.9990434086,5.1707644975,14.917655575
"2560","48073","Cherokee County","Texas",776,531,95,42,245,137,15.095367317,10.329433048,1.8480153288,0.8170173033,4.765934269,2.6650326321
"2561","48075","Childress County","Texas",67,80,-18,4,-13,-14,9.3308265441,11.141285426,-2.506789221,0.5570642713,-1.810458882,-1.94972495
"2562","48077","Clay County","Texas",87,128,13,10,-41,23,8.3920131185,12.346869876,1.2539789717,0.964599209,-3.954856757,2.2185781808
"2563","48079","Cochran County","Texas",40,33,7,15,7,22,13.515796587,11.150532184,2.3652644028,5.0684237202,2.3652644028,7.433688123
"2564","48081","Coke County","Texas",35,50,25,1,-15,26,10.866190624,15.523129463,7.7615647314,0.3104625893,-4.656938839,8.0720273207
"2565","48083","Coleman County","Texas",78,149,-36,7,-71,-29,9.3228948784,17.809119704,-4.302874559,0.8366700532,-8.486224825,-3.466204506
"2566","48085","Collin County","Texas",10796,3920,16810,5989,6876,22799,11.985620808,4.351948274,18.662308797,6.6489332176,7.6336725337,25.311242015
"2567","48087","Collingsworth County","Texas",32,40,2,4,-8,6,10.615359098,13.269198872,0.6634599436,1.3269198872,-2.653839774,1.9903798308
"2568","48089","Colorado County","Texas",250,252,176,55,-2,231,12.009415382,12.105490705,8.4546284287,2.642071384,-0.096075323,11.096699813
"2569","48091","Comal County","Texas",1524,1026,4826,183,498,5009,12.096294121,8.1435680893,38.304931383,1.4525077586,3.9527260316,39.757439142
"2570","48093","Comanche County","Texas",142,167,-74,15,-25,-59,10.57176891,12.432995831,-5.509231686,1.1167361525,-1.861226921,-4.392495533
"2571","48095","Concho County","Texas",32,33,30,42,-1,72,7.7304022225,7.9719772919,7.2472520836,10.146152917,-0.241575069,17.393405001
"2572","48097","Cooke County","Texas",550,398,195,59,152,254,14.112696295,10.212460228,5.0035923227,1.5139074207,3.9002360669,6.5174997434
"2573","48099","Coryell County","Texas",1065,485,-1095,528,580,-567,13.978671042,6.3658736669,-14.37243642,6.9302707137,7.6127973749,-7.44216571
"2574","48101","Cottle County","Texas",16,28,22,0,-12,22,11.157601116,19.525801953,15.341701534,0,-8.368200837,15.341701534
"2575","48103","Crane County","Texas",67,39,59,11,28,70,13.527155259,7.874015748,11.911972542,2.2208762366,5.6531395114,14.132848779
"2576","48105","Crockett County","Texas",49,27,-85,10,22,-75,13.018065887,7.1732199787,-22.58235919,2.6567481403,5.8448459086,-19.92561105
"2577","48107","Crosby County","Texas",103,86,75,1,17,76,17.543859649,14.648271163,12.774655084,0.1703287345,2.8955884858,12.944983819
"2578","48109","Culberson County","Texas",32,9,-53,1,23,-52,14.100022031,3.9656311963,-23.35316149,0.4406256885,10.134390835,-22.9125358
"2579","48111","Dallam County","Texas",151,40,-88,40,111,-48,20.810363837,5.5126791621,-12.12789416,5.5126791621,15.297684675,-6.615214994
"2580","48113","Dallas County","Texas",40130,15708,-1570,15880,24422,14310,15.801243743,6.1850470149,-0.6181897,6.252772256,9.6161967277,5.6345825556
"2581","48115","Dawson County","Texas",186,143,-538,25,43,-513,14.070655874,10.817762312,-40.69899387,1.8912171874,3.2528935623,-38.80777669
"2582","48117","Deaf Smith County","Texas",352,154,-514,22,198,-492,18.531192419,8.1073966833,-27.05975257,1.1581995262,10.423795736,-25.90155304
"2583","48119","Delta County","Texas",76,73,15,0,3,15,14.761581043,14.178887054,2.9134699427,0,0.5826939885,2.9134699427
"2584","48121","Denton County","Texas",9920,3349,16611,2684,6571,19295,12.942306927,4.3693332559,21.671840763,3.5017290113,8.5729736711,25.173569774
"2585","48123","DeWitt County","Texas",306,269,67,9,37,76,14.870611104,13.072530677,3.2559834771,0.4373709148,1.7980804277,3.6933543919
"2586","48125","Dickens County","Texas",15,23,0,4,-8,4,6.7827266561,10.400180873,0,1.8087271083,-3.617454217,1.8087271083
"2587","48127","Dimmit County","Texas",185,114,-141,11,71,-130,16.865712462,10.392925517,-12.85440788,1.0028261464,6.472786945,-11.85158173
"2588","48129","Donley County","Texas",35,57,-74,3,-22,-71,10.180337405,16.579406632,-21.52414194,0.872600349,-6.399069226,-20.65154159
"2589","48131","Duval County","Texas",180,131,-232,4,49,-228,15.747342636,11.460566029,-20.29657495,0.3499409475,4.2867766064,-19.94663401
"2590","48133","Eastland County","Texas",213,276,-64,31,-63,-33,11.694622121,15.153594861,-3.513877069,1.7020342054,-3.45897274,-1.811842864
"2591","48135","Ector County","Texas",3170,1201,2883,359,1969,3242,20.152126304,7.6349222999,18.327627802,2.282212411,12.517204004,20.609840213
"2592","48137","Edwards County","Texas",22,31,17,1,-9,18,11.530398323,16.247379455,8.9098532495,0.5241090147,-4.716981132,9.4339622642
"2593","48139","Ellis County","Texas",2152,1151,2938,173,1001,3111,13.339532001,7.1346660468,18.211684488,1.0723694406,6.2048659538,19.284053928
"2594","48141","El Paso County","Texas",13695,5297,-12896,3331,8398,-9565,16.411486723,6.3476922358,-15.4540002,3.9917241528,10.063794487,-11.46227605
"2595","48143","Erath County","Texas",473,309,486,9,164,495,11.575122053,7.5617604953,11.893254371,0.2202454513,4.0133615574,12.113499823
"2596","48145","Falls County","Texas",211,199,-6,13,12,7,12.2514153,11.554652344,-0.348381478,0.7548265351,0.6967629554,0.4064450573
"2597","48147","Fannin County","Texas",333,455,-23,53,-122,30,9.9257802021,13.562252228,-0.685564398,1.579778831,-3.636472026,0.8942144326
"2598","48149","Fayette County","Texas",263,327,211,24,-64,235,10.571589356,13.14414342,8.4813891792,0.9647077739,-2.572554064,9.4460969531
"2599","48151","Fisher County","Texas",41,65,20,10,-24,30,10.539845758,16.709511568,5.1413881748,2.5706940874,-6.16966581,7.7120822622
"2600","48153","Floyd County","Texas",64,68,-103,10,-4,-93,10.849296491,11.527377522,-17.46058654,1.6952025767,-0.678081031,-15.76538396
"2601","48155","Foard County","Texas",10,21,-39,0,-11,-39,7.9936051159,16.786570743,-31.17505995,0,-8.792965627,-31.17505995
"2602","48157","Fort Bend County","Texas",9655,2945,17933,5846,6710,23779,13.798652577,4.2089105996,25.62933575,8.3549376452,9.5897419773,33.984273395
"2603","48159","Franklin County","Texas",111,127,57,-4,-16,53,10.484556532,11.99584396,5.3839614622,-0.377821857,-1.511287428,5.0061396052
"2604","48161","Freestone County","Texas",219,220,51,23,-1,74,11.111392983,11.162129937,2.5875846673,1.166949948,-0.050736954,3.7545346153
"2605","48163","Frio County","Texas",283,147,2,188,136,190,14.810938113,7.6933141437,0.1046709407,9.8390684286,7.1176239696,9.9437393694
"2606","48165","Gaines County","Texas",438,120,441,129,318,570,22.126240812,6.0619837842,22.277790407,6.516632568,16.064257028,28.794422975
"2607","48167","Galveston County","Texas",4121,2705,5483,619,1416,6102,12.991209418,8.5273529426,17.284834079,1.9513609876,4.4638564757,19.236195067
"2608","48169","Garza County","Texas",62,61,-103,62,1,-41,9.6318160634,9.4764641914,-16.00124281,9.6318160634,0.155351872,-6.369426752
"2609","48171","Gillespie County","Texas",258,308,461,44,-50,505,10.029349453,11.973021827,17.920659294,1.7104316896,-1.943672375,19.631090983
"2610","48173","Glasscock County","Texas",17,9,34,11,8,45,12.564671101,6.6518847007,25.129342203,8.1300813008,5.9127864006,33.259423503
"2611","48175","Goliad County","Texas",79,88,19,-3,-9,16,10.522810523,11.721611722,2.5308025308,-0.3996004,-1.198801199,2.1312021312
"2612","48177","Gonzales County","Texas",329,180,19,1,149,20,16.088806299,8.8023864248,0.9291407893,0.0489021468,7.2864198738,0.9780429361
"2613","48179","Gray County","Texas",351,269,-282,14,82,-268,15.036627683,11.523797284,-12.08070942,0.5997515315,3.5128303988,-11.48095789
"2614","48181","Grayson County","Texas",1561,1401,1669,192,160,1861,12.524973722,11.241183975,13.391531802,1.5405476968,1.2837897473,14.932079499
"2615","48183","Gregg County","Texas",1939,1276,-110,204,663,94,15.694749665,10.328262286,-0.890367438,1.6512268859,5.366487379,0.7608594474
"2616","48185","Grimes County","Texas",320,308,271,19,12,290,11.784635781,11.342711939,9.9801134271,0.6997127495,0.4419238418,10.679826177
"2617","48187","Guadalupe County","Texas",1783,1055,2924,136,728,3060,11.986030863,7.0921270667,19.656283927,0.9142457641,4.8939037958,20.570529691
"2618","48189","Hale County","Texas",459,321,-582,41,138,-541,13.395788644,9.3682966335,-16.98550978,1.1965737133,4.0274920107,-15.78893607
"2619","48191","Hall County","Texas",26,60,57,1,-34,58,8.4278768233,19.448946515,18.47649919,0.3241491086,-11.02106969,18.800648298
"2620","48193","Hamilton County","Texas",86,145,-29,9,-59,-20,10.592437492,17.859342284,-3.571868457,1.1085109004,-7.266904791,-2.463357556
"2621","48195","Hansford County","Texas",95,56,16,32,39,48,16.950664644,9.9919707378,2.8548487822,5.7096975645,6.9586939067,8.5645463467
"2622","48197","Hardeman County","Texas",44,57,-73,8,-13,-65,11.130786744,14.419428282,-18.4669871,2.023779408,-3.288641538,-16.44320769
"2623","48199","Hardin County","Texas",686,548,106,16,138,122,12.33047839,9.8500031455,1.9052925792,0.2875913327,2.4804752447,2.192883912
"2624","48201","Harris County","Texas",72306,25080,17631,38528,47226,56159,16.031220817,5.560576136,3.9090318123,8.5421801183,10.470644681,12.451211931
"2625","48203","Harrison County","Texas",813,646,-139,75,167,-64,12.196219622,9.6909690969,-2.085208521,1.1251125113,2.5052505251,-0.96009601
"2626","48205","Hartley County","Texas",61,43,-406,20,18,-386,10.377679483,7.3154134059,-69.07111262,3.4025178632,3.0622660769,-65.66859476
"2627","48207","Haskell County","Texas",59,84,-5,64,-25,59,10.127016821,14.418125644,-0.858221765,10.985238586,-4.291108823,10.127016821
"2628","48209","Hays County","Texas",2449,886,7679,311,1563,7990,12.906932008,4.6694739727,40.470531192,1.6390591484,8.2374580353,42.109590341
"2629","48211","Hemphill County","Texas",79,25,49,6,54,55,18.727035676,5.9262771127,11.615503141,1.4223065071,12.800758563,13.037809648
"2630","48213","Henderson County","Texas",888,1075,313,86,-187,399,11.183245282,13.538275539,3.941842087,1.0830620431,-2.355030256,5.0249041301
"2631","48215","Hidalgo County","Texas",16331,4150,-3988,2084,12181,-1904,19.536032682,4.9644562874,-4.770663054,2.4929944344,14.571576394,-2.27766862
"2632","48217","Hill County","Texas",399,437,97,39,-38,136,11.457779947,12.548997085,2.7854753256,1.1199333783,-1.091217138,3.9054087039
"2633","48219","Hockley County","Texas",305,209,-257,9,96,-248,13.038088317,8.9342965844,-10.98619245,0.3847304749,4.1037917326,-10.60146198
"2634","48221","Hood County","Texas",634,765,1515,67,-131,1582,11.621299606,14.022546054,27.770140225,1.2281184126,-2.401246449,28.998258638
"2635","48223","Hopkins County","Texas",451,397,235,7,54,242,12.582652122,11.076081801,6.5563708395,0.1952961527,1.5065703206,6.7516669922
"2636","48225","Houston County","Texas",219,281,-14,23,-62,9,9.6109538543,12.331863165,-0.614398877,1.0093695829,-2.72090931,0.3949707063
"2637","48227","Howard County","Texas",507,392,437,123,115,560,13.724216339,10.611228412,11.829354123,3.3295436089,3.112987927,15.158897732
"2638","48229","Hudspeth County","Texas",43,14,130,70,29,200,12.560245363,4.0893822112,37.972834818,20.446911056,8.4708631517,58.419745874
"2639","48231","Hunt County","Texas",1162,921,677,125,241,802,13.027051873,10.325227861,7.5897711858,1.4013610018,2.7018240115,8.9911321876
"2640","48233","Hutchinson County","Texas",284,274,-138,17,10,-121,12.988497862,12.531156388,-6.311312341,0.7774805058,0.457341474,-5.533831836
"2641","48235","Irion County","Texas",11,15,-28,0,-4,-28,7.0580686558,9.624639076,-17.96599294,0,-2.56657042,-17.96599294
"2642","48237","Jack County","Texas",101,91,-7,-3,10,-10,11.368752814,10.243133724,-0.787933363,-0.337685727,1.1256190905,-1.12561909
"2643","48239","Jackson County","Texas",210,161,13,20,49,33,14.219934995,10.901950163,0.8802816901,1.3542795233,3.3179848321,2.2345612134
"2644","48241","Jasper County","Texas",430,456,-123,-7,-26,-130,12.167343416,12.903043251,-3.48042614,-0.198073032,-0.735699834,-3.678499172
"2645","48243","Jeff Davis County","Texas",13,13,-22,6,0,-16,5.8876811594,5.8876811594,-9.963768116,2.7173913043,0,-7.246376812
"2646","48245","Jefferson County","Texas",3704,2500,264,880,1204,1144,14.578458596,9.8396723783,1.0390694031,3.4635646772,4.7387862174,4.5026340803
"2647","48247","Jim Hogg County","Texas",83,52,-88,30,31,-58,15.60003759,9.7735175265,-16.53979889,5.6385678038,5.8265200639,-10.90123109
"2648","48249","Jim Wells County","Texas",673,410,-311,68,263,-243,16.211203315,9.8760673981,-7.491358441,1.6379819099,6.3351359164,-5.853376531
"2649","48251","Johnson County","Texas",2105,1323,1800,25,782,1825,13.317643188,8.3701861939,11.388008427,0.1581667837,4.9474569945,11.546175211
"2650","48253","Jones County","Texas",159,202,158,8,-43,166,7.9863378372,10.146165051,7.9361092973,0.4018283189,-2.159827214,8.3379376162
"2651","48255","Karnes County","Texas",176,148,359,91,28,450,11.612179593,9.764787385,23.686207238,6.0040246759,1.847392208,29.690231914
"2652","48257","Kaufman County","Texas",1537,899,2471,92,638,2563,13.659004768,7.9892292038,21.959271816,0.817585191,5.669775564,22.776857007
"2653","48259","Kendall County","Texas",360,355,1490,49,5,1539,9.187540674,9.0599359424,38.026210012,1.2505263695,0.1276047316,39.276736381
"2654","48261","Kenedy County","Texas",3,1,-8,9,2,1,6.8415051311,2.2805017104,-18.24401368,20.524515393,4.5610034208,2.2805017104
"2655","48263","Kent County","Texas",9,15,4,0,-6,4,12.040133779,20.066889632,5.3511705686,0,-8.026755853,5.3511705686
"2656","48265","Kerr County","Texas",536,751,676,53,-215,729,10.594141598,14.843657351,13.361268135,1.0475550461,-4.249515753,14.408823181
"2657","48267","Kimble County","Texas",41,53,-62,0,-12,-62,9.256123716,11.965233096,-13.99706513,0,-2.70910938,-13.99706513
"2658","48269","King County","Texas",2,1,18,0,1,18,7.3529411765,3.6764705882,66.176470588,0,3.6764705882,66.176470588
"2659","48271","Kinney County","Texas",38,55,29,42,-17,71,10.610079576,15.356694123,8.0971659919,11.726930057,-4.746614547,19.824096049
"2660","48273","Kleberg County","Texas",435,254,-770,155,181,-615,13.723046832,8.0129974604,-24.29137025,4.8898212849,5.7100493714,-19.40154897
"2661","48275","Knox County","Texas",54,54,-13,5,0,-8,14.218009479,14.218009479,-3.422854134,1.3164823591,0,-2.106371775
"2662","48277","Lamar County","Texas",654,648,-54,13,6,-41,13.239268399,13.117807221,-1.093150602,0.2631658856,0.121461178,-0.829984716
"2663","48279","Lamb County","Texas",206,165,-274,11,41,-263,15.402444951,12.336909791,-20.48674717,0.8224606527,3.0655351602,-19.66428652
"2664","48281","Lampasas County","Texas",230,174,186,23,56,209,11.360268695,8.5942902302,9.1869999012,1.1360268695,2.7659784649,10.323026771
"2665","48283","La Salle County","Texas",110,55,77,31,55,108,14.534883721,7.2674418605,10.174418605,4.0961945032,7.2674418605,14.270613108
"2666","48285","Lavaca County","Texas",235,269,160,8,-34,168,11.839089146,13.551978639,8.0606564397,0.403032822,-1.712889493,8.4636892617
"2667","48287","Lee County","Texas",220,160,189,-3,60,186,13.134720439,9.5525239559,11.283918923,-0.179109824,3.5821964835,11.104809099
"2668","48289","Leon County","Texas",213,222,300,4,-9,304,12.614373279,13.147374967,17.766722928,0.236889639,-0.533001688,18.003612567
"2669","48291","Liberty County","Texas",1075,765,1138,98,310,1236,13.636334807,9.7039963975,14.435487451,1.2431263359,3.9323384094,15.678613787
"2670","48293","Limestone County","Texas",316,282,-136,40,34,-96,13.443090209,11.996681769,-5.785633761,1.7016569885,1.4464084402,-4.083976772
"2671","48295","Lipscomb County","Texas",43,22,-20,9,21,-11,12.085441259,6.1832490163,-5.621135469,2.5295109612,5.9021922428,-3.091624508
"2672","48297","Live Oak County","Texas",136,140,100,23,-4,123,11.223900305,11.55401502,8.2528678716,1.8981596105,-0.330114715,10.151027482
"2673","48299","Llano County","Texas",167,299,538,5,-132,543,8.4035727764,15.045917726,27.072587747,0.2516039753,-6.642344949,27.324191722
"2674","48301","Loving County","Texas",2,2,29,0,0,29,19.230769231,19.230769231,278.84615385,0,0,278.84615385
"2675","48303","Lubbock County","Texas",4213,2459,1658,470,1754,2128,14.212629438,8.2954796552,5.5932920977,1.5855532484,5.9171497825,7.1788453461
"2676","48305","Lynn County","Texas",61,57,-58,1,4,-57,10.566429932,9.8735492811,-10.04676944,0.1732201628,0.6928806513,-9.873549281
"2677","48307","McCulloch County","Texas",96,112,110,5,-16,115,11.695906433,13.645224172,13.401559454,0.6091617934,-1.949317739,14.010721248
"2678","48309","McLennan County","Texas",3629,2185,465,426,1444,891,14.850340568,8.9413045302,1.9028405522,1.7432474736,5.9090360373,3.6460880258
"2679","48311","McMullen County","Texas",13,5,18,8,8,26,15.902140673,6.1162079511,22.018348624,9.7859327217,9.7859327217,31.804281346
"2680","48313","Madison County","Texas",158,124,47,21,34,68,11.350982435,8.9083659614,3.376558066,1.5086748806,2.4426164733,4.8852329466
"2681","48315","Marion County","Texas",102,182,64,-1,-80,63,10.055205047,17.941640379,6.309148265,-0.098580442,-7.886435331,6.2105678233
"2682","48317","Martin County","Texas",114,50,109,17,64,126,20.512820513,8.9968511021,19.613135403,3.0589293747,11.515969411,22.672064777
"2683","48319","Mason County","Texas",42,51,-44,14,-9,-30,10.301692421,12.50919794,-10.7922492,3.4338974736,-2.207505519,-7.358351729
"2684","48321","Matagorda County","Texas",538,387,110,15,151,125,14.684207653,10.562803646,3.0023472897,0.409410994,4.1214040068,3.4117582837
"2685","48323","Maverick County","Texas",1191,405,-459,281,786,-178,20.712503152,7.0432945228,-7.982400459,4.8868290392,13.669208629,-3.09557142
"2686","48325","Medina County","Texas",603,426,376,30,177,406,12.528828773,8.8512123668,7.8123376758,0.6233248146,3.6776164059,8.4356624904
"2687","48327","Menard County","Texas",16,42,30,2,-26,32,7.508212107,19.709056781,14.077897701,0.9385265134,-12.20084467,15.016424214
"2688","48329","Midland County","Texas",2916,1078,3157,517,1838,3674,18.273768119,6.7555288175,19.78404868,3.2398964737,11.518239301,23.023945154
"2689","48331","Milam County","Texas",327,304,189,16,23,205,13.480366897,12.532206534,7.7914047202,0.6595898176,0.9481603628,8.4509945378
"2690","48333","Mills County","Texas",56,57,16,4,-1,20,11.475409836,11.680327869,3.2786885246,0.8196721311,-0.204918033,4.0983606557
"2691","48335","Mitchell County","Texas",99,104,-212,2,-5,-210,11.038019846,11.595495596,-23.63697179,0.2229902999,-0.55747575,-23.41398149
"2692","48337","Montague County","Texas",231,287,-56,4,-56,-52,11.961165049,14.860841424,-2.899676375,0.2071197411,-2.899676375,-2.692556634
"2693","48339","Montgomery County","Texas",7100,3428,13123,1828,3672,14951,13.479494082,6.5081275654,24.914281809,3.4704950961,6.9713665169,28.384776905
"2694","48341","Moore County","Texas",431,168,-607,154,263,-453,19.666446123,7.6658073053,-27.69729187,7.0269900299,12.000638817,-20.67030184
"2695","48343","Morris County","Texas",139,172,-206,2,-33,-204,11.131131131,13.773773774,-16.4964965,0.1601601602,-2.642642643,-16.33633634
"2696","48345","Motley County","Texas",5,12,4,0,-7,4,4.3572984749,10.45751634,3.48583878,0,-6.100217865,3.48583878
"2697","48347","Nacogdoches County","Texas",862,618,-62,116,244,54,13.181839035,9.4505528115,-0.948113712,1.7738901717,3.7312862233,0.8257764593
"2698","48349","Navarro County","Texas",698,553,90,31,145,121,14.518074795,11.502142352,1.8719580681,0.6447855568,3.0159324431,2.5167436249
"2699","48351","Newton County","Texas",158,156,-135,0,2,-135,11.106815226,10.966222628,-9.490000351,0,0.1405925978,-9.490000351
"2700","48353","Nolan County","Texas",203,178,-60,8,25,-52,13.431255789,11.777160249,-3.969829297,0.529310573,1.6540955406,-3.440518724
"2701","48355","Nueces County","Texas",5143,2856,796,812,2287,1608,14.33862633,7.9624959748,2.2192390742,2.2638468948,6.3761303552,4.483085969
"2702","48357","Ochiltree County","Texas",196,101,-128,22,95,-106,18.28017161,9.4198843499,-11.93807126,2.051855997,8.8602872598,-9.886215258
"2703","48359","Oldham County","Texas",21,19,-7,0,2,-7,10.162109848,9.1942898621,-3.387369949,0,0.9678199855,-3.387369949
"2704","48361","Orange County","Texas",1200,936,442,0,264,442,14.354496247,11.196507073,5.2872394509,0,3.1579891743,5.2872394509
"2705","48363","Palo Pinto County","Texas",351,339,-99,23,12,-76,12.535714286,12.107142857,-3.535714286,0.8214285714,0.4285714286,-2.714285714
"2706","48365","Panola County","Texas",307,264,-148,24,43,-124,12.949761674,11.135951407,-6.242881849,1.0123592188,1.813810267,-5.23052263
"2707","48367","Parker County","Texas",1433,1080,3028,119,353,3147,11.56293245,8.7145617907,24.433049169,0.9602156047,2.8483706594,25.393264773
"2708","48369","Parmer County","Texas",155,85,-270,56,70,-214,15.668435684,8.5923679555,-27.29340409,5.6608541825,7.0760677281,-21.63254991
"2709","48371","Pecos County","Texas",222,126,80,0,96,80,13.941220799,7.9125847777,5.0238633509,0,6.0286360211,5.0238633509
"2710","48373","Polk County","Texas",516,680,802,141,-164,943,11.161341957,14.708745214,17.34766715,3.0499015812,-3.547403258,20.397568731
"2711","48375","Potter County","Texas",2001,1228,-2285,754,773,-1531,16.435048295,10.086076615,-18.76765885,6.1929167488,6.3489716801,-12.5747421
"2712","48377","Presidio County","Texas",135,50,-290,73,85,-217,18.874519399,6.9905627403,-40.54526389,10.206221601,11.883956659,-30.33904229
"2713","48379","Rains County","Texas",102,149,157,13,-47,170,9.2107639516,13.454939498,14.177352357,1.1739208958,-4.244175546,15.351273253
"2714","48381","Randall County","Texas",1756,1066,823,199,690,1022,13.550480556,8.2259750983,6.3508231763,1.5356182407,5.3245054576,7.8864414169
"2715","48383","Reagan County","Texas",49,25,-40,39,24,-1,12.896433741,6.5798131333,-10.52770101,10.264508488,6.316620608,-0.263192525
"2716","48385","Real County","Texas",42,41,-54,1,1,-53,12.641083521,12.340105342,-16.25282167,0.3009781791,0.3009781791,-15.95184349
"2717","48387","Red River County","Texas",106,180,-19,-2,-74,-21,8.5459749264,14.512032894,-1.531825694,-0.16124481,-5.966057968,-1.693070504
"2718","48389","Reeves County","Texas",209,104,174,115,105,289,14.163730008,7.0479804825,11.7918135,7.7934399566,7.1157495256,19.585253456
"2719","48391","Refugio County","Texas",102,107,-36,7,-5,-29,13.895511205,14.576663715,-4.904298072,0.9536135141,-0.68115251,-3.950684558
"2720","48393","Roberts County","Texas",6,8,0,0,-2,0,6.5789473684,8.7719298246,0,0,-2.192982456,0
"2721","48395","Robertson County","Texas",211,195,188,27,16,215,12.722723025,11.757966776,11.335885918,1.628026169,0.9647562483,12.963912087
"2722","48397","Rockwall County","Texas",927,544,2538,144,383,2682,10.460274653,6.1384999041,28.638810214,1.6248970334,4.3217747486,30.263707248
"2723","48399","Runnels County","Texas",93,135,118,20,-42,138,8.989415688,13.049151805,11.405925282,1.9332076748,-4.059736117,13.339132956
"2724","48401","Rusk County","Texas",585,557,-298,41,28,-257,11.012386582,10.485297993,-5.609728549,0.7718082904,0.5270885885,-4.837920259
"2725","48403","Sabine County","Texas",91,181,108,-4,-90,104,8.7181452386,17.340486683,10.346809734,-0.383215175,-8.622341445,9.9635945583
"2726","48405","San Augustine County","Texas",105,141,-96,0,-36,-96,12.479942949,16.758780531,-11.41023355,0,-4.278837582,-11.41023355
"2727","48407","San Jacinto County","Texas",277,302,343,-14,-25,329,10.182138984,11.101104597,12.608208201,-0.514620743,-0.918965612,12.093587458
"2728","48409","San Patricio County","Texas",1044,576,-75,76,468,1,15.606430926,8.6104446487,-1.121151647,1.1361003356,6.9959862771,0.0149486886
"2729","48411","San Saba County","Texas",63,57,49,15,6,64,10.685210312,9.6675712347,8.3107191316,2.5440976934,1.0176390773,10.854816825
"2730","48413","Schleicher County","Texas",24,23,30,-1,1,29,7.5471698113,7.2327044025,9.4339622642,-0.314465409,0.3144654088,9.1194968553
"2731","48415","Scurry County","Texas",226,167,119,11,59,130,12.934241401,9.5576031592,6.8105076404,0.6295427231,3.3766382419,7.4400503634
"2732","48417","Shackelford County","Texas",37,29,7,0,8,7,11.116118372,8.7126333183,2.1030494217,0,2.4034850533,2.1030494217
"2733","48419","Shelby County","Texas",357,309,-279,20,48,-259,13.989576394,12.108624946,-10.93303029,0.78372977,1.8809514479,-10.14930052
"2734","48421","Sherman County","Texas",41,31,-25,2,10,-23,13.409648406,10.139002453,-8.176614881,0.6541291905,3.2706459526,-7.522485691
"2735","48423","Smith County","Texas",3115,2041,1402,374,1074,1776,14.093364582,9.2342077403,6.3431451503,1.6921086207,4.8591568413,8.035253771
"2736","48425","Somervell County","Texas",82,86,65,-3,-4,62,9.544872541,10.01047608,7.566057502,-0.349202654,-0.465603539,7.2168548481
"2737","48427","Starr County","Texas",1336,389,-558,145,947,-413,21.096846527,6.1427195351,-8.811407457,2.2897026545,14.954126992,-6.521704802
"2738","48429","Stephens County","Texas",91,106,59,0,-15,59,9.7144382172,11.315719242,6.298372031,0,-1.601281025,6.298372031
"2739","48431","Sterling County","Texas",13,9,-11,2,4,-9,9.7123645872,6.7239447142,-8.218154651,1.4942099365,2.988419873,-6.723944714
"2740","48433","Stonewall County","Texas",16,23,16,2,-7,18,11.481880158,16.505202727,11.481880158,1.4352350197,-5.023322569,12.917115178
"2741","48435","Sutton County","Texas",44,33,-83,16,11,-67,11.159015978,8.3692619833,-21.04996196,4.0578239919,2.7897539944,-16.99213797
"2742","48437","Swisher County","Texas",92,91,-77,4,1,-73,12.234856041,12.101868475,-10.24004256,0.5319502627,0.1329875657,-9.708092293
"2743","48439","Tarrant County","Texas",28572,12368,14287,8794,16204,23081,14.530981449,6.2900454487,7.2659992987,4.4724013322,8.2409360003,11.738400631
"2744","48441","Taylor County","Texas",2105,1328,-88,467,777,379,15.526804945,9.7955330009,-0.649101584,3.4446640899,5.7312719441,2.7955625055
"2745","48443","Terrell County","Texas",13,16,-43,4,-3,-39,14.606741573,17.97752809,-48.31460674,4.4943820225,-3.370786517,-43.82022472
"2746","48445","Terry County","Texas",195,129,-114,10,66,-104,15.262993112,10.097056982,-8.922980589,0.7827175955,5.1659361302,-8.140262993
"2747","48447","Throckmorton County","Texas",8,22,-40,0,-14,-40,5.0441361917,13.871374527,-25.22068096,0,-8.827238335,-25.22068096
"2748","48449","Titus County","Texas",536,309,-144,85,227,-59,16.434911923,9.474604075,-4.415349472,2.6062826744,6.960307848,-1.809066797
"2749","48451","Tom Green County","Texas",1727,1042,416,80,685,496,14.771541475,8.9125339993,3.5581709633,0.6842636468,5.8590074756,4.2424346101
"2750","48453","Travis County","Texas",16388,5336,9164,7019,11052,16183,14.04927964,4.5745030607,7.8562117782,6.0173232727,9.4747765793,13.873535051
"2751","48455","Trinity County","Texas",152,219,295,15,-67,310,10.539453613,15.185133823,20.45486063,1.0400776591,-4.645680211,21.494938289
"2752","48457","Tyler County","Texas",211,267,-38,11,-56,-27,9.8531368932,12.468187443,-1.774498587,0.5136706437,-2.61505055,-1.260827944
"2753","48459","Upshur County","Texas",475,480,45,18,-5,63,11.782945736,11.906976744,1.1162790698,0.4465116279,-0.124031008,1.5627906977
"2754","48461","Upton County","Texas",48,33,144,12,15,156,13.447261521,9.2449922958,40.341784564,3.3618153803,4.2022692254,43.703599944
"2755","48463","Uvalde County","Texas",440,236,-289,7,204,-282,16.292072426,8.7384752101,-10.70092939,0.2591920613,7.5535972155,-10.44173733
"2756","48465","Val Verde County","Texas",925,366,-640,152,559,-488,18.910741301,7.4825203418,-13.08418858,3.1074947868,11.428220959,-9.976693789
"2757","48467","Van Zandt County","Texas",564,654,654,77,-90,731,10.617170072,12.311399339,12.311399339,1.4495072617,-1.694229267,13.760906601
"2758","48469","Victoria County","Texas",1352,806,472,104,546,576,14.75684496,8.7973498802,5.1517979447,1.13514192,5.9594950801,6.2869398648
"2759","48471","Walker County","Texas",658,496,378,238,162,616,9.3368429268,7.0381065223,5.3637182771,3.3771559522,2.2987364045,8.7408742293
"2760","48473","Waller County","Texas",683,324,1406,83,359,1489,14.310108216,6.7883968698,29.45829012,1.7390029018,7.5217113465,31.197293022
"2761","48475","Ward County","Texas",185,129,-9,14,56,5,15.943465334,11.117335287,-0.775628043,1.2065325117,4.826130047,0.4309044685
"2762","48477","Washington County","Texas",417,401,380,30,16,410,12.045582564,11.583401938,10.976789867,0.8665886737,0.462180626,11.84337854
"2763","48479","Webb County","Texas",5421,1352,-2669,973,4069,-1696,20.15796167,5.0274053085,-9.92466329,3.6180956843,15.130556361,-6.306567606
"2764","48481","Wharton County","Texas",550,433,172,20,117,192,13.32525742,10.49061175,4.1671714113,0.4845548153,2.8346456693,4.6517262265
"2765","48483","Wheeler County","Texas",83,85,-41,7,-2,-34,14.608818094,14.960837807,-7.216404119,1.2320689959,-0.352019713,-5.984335123
"2766","48485","Wichita County","Texas",1762,1341,-2599,533,421,-2066,13.364532412,10.17130418,-19.71306455,4.0427331303,3.1932282324,-15.67033142
"2767","48487","Wilbarger County","Texas",176,162,48,15,14,63,13.508327577,12.43380152,3.6840893392,1.1512779185,1.0745260573,4.8353672577
"2768","48489","Willacy County","Texas",314,179,-232,31,135,-201,14.315674296,8.1608461749,-10.5771861,1.4133309018,6.1548281207,-9.163855202
"2769","48491","Williamson County","Texas",6434,2500,13506,1409,3934,14915,12.930778932,5.0243934301,27.143783067,2.8317481372,7.9063855016,29.975531204
"2770","48493","Wilson County","Texas",558,433,864,27,125,891,11.955520322,9.2773123648,18.511773402,0.5784929188,2.6782079575,19.090266321
"2771","48495","Winkler County","Texas",130,65,110,12,65,122,16.415177726,8.2075888629,13.889765768,1.5152471747,8.2075888629,15.405012943
"2772","48497","Wise County","Texas",820,551,837,41,269,878,13.166134134,8.8469998876,13.439090573,0.6583067067,4.3191342464,14.09739728
"2773","48499","Wood County","Texas",426,629,540,3,-203,543,9.9193182215,14.646129487,12.573783661,0.0698543537,-4.726811265,12.643638015
"2774","48501","Yoakum County","Texas",177,67,65,69,110,134,20.760028149,7.8583157401,7.6237391508,8.0928923293,12.901712409,15.71663148
"2775","48503","Young County","Texas",236,268,-101,22,-32,-79,12.951732843,14.707900008,-5.542902615,1.207364926,-1.756167165,-4.335537689
"2776","48505","Zapata County","Texas",300,82,-120,9,218,-111,20.750475532,5.6717966453,-8.300190213,0.622514266,15.078678886,-7.677675947
"2777","48507","Zavala County","Texas",206,107,-76,41,99,-35,16.7609129,8.7059110695,-6.183637769,3.3359098491,8.0550018307,-2.84772792
"2778","49001","Beaver County","Utah",111,69,-131,10,42,-121,17.370892019,10.798122066,-20.50078247,1.5649452269,6.5727699531,-18.93583725
"2779","49003","Box Elder County","Utah",902,404,32,6,498,38,17.491637175,7.8343918166,0.6205458865,0.1163523537,9.657245358,0.7368982402
"2780","49005","Cache County","Utah",2354,521,-173,224,1833,51,19.808145406,4.3840457758,-1.455738808,1.8848872434,15.42409963,0.4291484349
"2781","49007","Carbon County","Utah",266,228,-297,8,38,-289,12.969599454,11.116799532,-14.48109413,0.3900631415,1.852799922,-14.09103099
"2782","49009","Daggett County","Utah",11,10,-20,0,1,-20,9.8698968147,8.9726334679,-17.94526694,0,0.8972633468,-17.94526694
"2783","49011","Davis County","Utah",5889,1719,1603,172,4170,1775,17.753138227,5.1821437615,4.832447033,0.5185158389,12.570994465,5.3509628719
"2784","49013","Duchesne County","Utah",444,145,244,8,299,252,21.678628973,7.0797324349,11.913480787,0.3906059274,14.598896538,12.304086715
"2785","49015","Emery County","Utah",139,79,-344,1,60,-343,13.239986665,7.5248845073,-32.7665857,0.0952517026,5.7151021575,-32.671334
"2786","49017","Garfield County","Utah",50,34,-64,10,16,-54,10.026067776,6.8177260878,-12.83336675,2.0052135552,3.2083416884,-10.8281532
"2787","49019","Grand County","Utah",130,89,27,10,41,37,13.661202186,9.3526691887,2.8373266078,1.0508617066,4.3085329971,3.8881883144
"2788","49021","Iron County","Utah",860,286,529,-29,574,500,18.073871697,6.0106131456,11.117532706,-0.609467767,12.063258551,10.50806494
"2789","49023","Juab County","Utah",170,72,36,-2,98,34,16.229116945,6.8735083532,3.4367541766,-0.190930788,9.3556085919,3.245823389
"2790","49025","Kane County","Utah",81,85,-120,-3,-4,-123,11.403632268,11.966774602,-16.89427003,-0.422356751,-0.563142334,-17.31662678
"2791","49027","Millard County","Utah",196,88,-33,8,108,-25,15.573477414,6.992173533,-2.622065075,0.6356521394,8.5813038815,-1.986412936
"2792","49029","Morgan County","Utah",177,49,301,12,128,313,16.352549889,4.526977088,27.80857354,1.1086474501,11.825572801,28.91722099
"2793","49031","Piute County","Utah",13,11,23,0,2,23,8.7897227857,7.4374577417,15.551048005,0,1.3522650439,15.551048005
"2794","49033","Rich County","Utah",34,20,9,3,14,12,14.866637516,8.745080892,3.9352864014,1.3117621338,6.1215566244,5.2470485352
"2795","49035","Salt Lake County","Utah",17598,6594,-1073,2589,11004,1516,16.050081947,6.0139925194,-0.978619044,2.3612718582,10.036089427,1.3826528146
"2796","49037","San Juan County","Utah",242,100,35,13,142,48,15.977815925,6.6024032748,2.3108411462,0.8583124257,9.3754126502,3.1691535719
"2797","49039","Sanpete County","Utah",370,185,167,18,185,185,12.992029215,6.4960146073,5.8639699428,0.6320446645,6.4960146073,6.4960146073
"2798","49041","Sevier County","Utah",329,203,-4,5,126,1,15.81920904,9.7607885563,-0.192330809,0.2404135112,6.0584204832,0.0480827022
"2799","49043","Summit County","Utah",443,141,127,106,302,233,11.248651051,3.5802704247,3.2247825811,2.6915508157,7.6683806259,5.9163333968
"2800","49045","Tooele County","Utah",954,362,557,24,592,581,15.379283106,5.8357447426,8.9793088995,0.3869002039,9.5435383636,9.3662091034
"2801","49047","Uintah County","Utah",722,245,372,13,477,385,19.329620904,6.5592203898,9.9593060613,0.3480402656,12.770400514,10.307346327
"2802","49049","Utah County","Utah",11925,2388,1916,487,9537,2403,21.042861264,4.2138660545,3.3809746065,0.8593604558,16.82899521,4.2403350623
"2803","49051","Wasatch County","Utah",472,126,933,32,346,965,16.570415489,4.4234583721,32.754656041,1.1234179993,12.146957117,33.87807404
"2804","49053","Washington County","Utah",2233,1197,2528,-21,1036,2507,14.604841901,7.8289277901,16.534276903,-0.13734961,6.7759141107,16.396927293
"2805","49055","Wayne County","Utah",28,27,-15,9,1,-6,10.395396324,10.02413217,-5.568962317,3.34137739,0.3712641544,-2.227584927
"2806","49057","Weber County","Utah",3871,1770,432,238,2101,670,16.023180007,7.3265380038,1.7881719874,0.9851503079,8.6966420034,2.7733222952
"2807","50001","Addison County","Vermont",305,326,-105,120,-21,15,8.2589799483,8.8276310267,-2.843255392,3.2494347337,-0.568651078,0.4061793417
"2808","50003","Bennington County","Vermont",355,440,-17,93,-85,76,9.8155777366,12.16578649,-0.470041751,2.5714048718,-2.350208754,2.1013631211
"2809","50005","Caledonia County","Vermont",272,328,-186,17,-56,-169,8.8439466112,10.664759149,-6.047698786,0.5527466632,-1.820812538,-5.494952122
"2810","50007","Chittenden County","Vermont",1553,1134,-548,1476,419,928,9.6683320104,7.0598122986,-3.411620053,9.1889620395,2.6085197118,5.7773419869
"2811","50009","Essex County","Vermont",55,61,45,4,-6,49,8.9068825911,9.8785425101,7.2874493927,0.6477732794,-0.971659919,7.9352226721
"2812","50011","Franklin County","Vermont",600,453,-13,96,147,83,12.279732302,9.2711978879,-0.266060867,1.9647571683,3.0085344139,1.6986963018
"2813","50013","Grand Isle County","Vermont",68,66,-98,-1,2,-99,9.8287200983,9.5396400954,-14.16492014,-0.144540001,0.2890800029,-14.30946014
"2814","50015","Lamoille County","Vermont",275,187,3,20,88,23,10.919631512,7.4253494282,0.1191232529,0.7941550191,3.4942820839,0.9132782719
"2815","50017","Orange County","Vermont",261,259,-8,20,2,12,9.0361445783,8.9669020911,-0.276969949,0.6924248719,0.0692424872,0.4154549231
"2816","50019","Orleans County","Vermont",279,350,53,32,-71,85,10.323583282,12.950731716,1.9611108028,1.1840668998,-2.627148434,3.1451777025
"2817","50021","Rutland County","Vermont",520,682,-359,39,-162,-320,8.6972520029,11.406780511,-6.004448979,0.6522939002,-2.709528509,-5.352155079
"2818","50023","Washington County","Vermont",576,553,-392,53,23,-339,9.7955018919,9.4043620594,-6.666383232,0.9013222227,0.3911398325,-5.765061009
"2819","50025","Windham County","Vermont",359,460,-380,71,-101,-309,8.260944601,10.585054363,-8.744175344,1.63378013,-2.324109762,-7.110395214
"2820","50027","Windsor County","Vermont",491,635,-157,106,-144,-51,8.8260142726,11.41449911,-2.822167497,1.9054124499,-2.588484838,-0.916755047
"2821","51001","Accomack County","Virginia",404,467,-55,63,-63,8,12.26472374,14.177292046,-1.669702489,1.912568306,-1.912568306,0.2428658166
"2822","51003","Albemarle County","Virginia",1129,846,662,434,283,1096,10.810966092,8.1010427938,6.3391138647,4.1558541046,2.7099232986,10.494967969
"2823","51005","Alleghany County","Virginia",148,200,-124,-6,-52,-130,9.5416156276,12.894075172,-7.994326607,-0.386822255,-3.352459545,-8.381148862
"2824","51007","Amelia County","Virginia",138,135,67,-1,3,66,10.824378383,10.589065809,5.2553141423,-0.078437525,0.2353125735,5.1768766178
"2825","51009","Amherst County","Virginia",351,348,-349,14,3,-335,10.970464135,10.876699484,-10.90795437,0.4375683701,0.0937646507,-10.470386
"2826","51011","Appomattox County","Virginia",174,177,133,7,-3,140,11.286608504,11.481205202,8.6271202932,0.4540589628,-0.194596698,9.081179256
"2827","51013","Arlington County","Virginia",3133,964,-2072,2603,2169,531,13.777817845,4.2393285678,-9.111917834,11.447066662,9.5384892774,2.3351488273
"2828","51015","Augusta County","Virginia",671,702,431,17,-31,448,9.0569806915,9.4754104999,5.8175241103,0.2294615078,-0.418429808,6.0469856182
"2829","51017","Bath County","Virginia",49,74,-52,-3,-25,-55,10.899788678,16.46090535,-11.56712268,-0.667334001,-5.561116672,-12.23445668
"2830","51019","Bedford County","Virginia",657,713,569,46,-56,615,8.4969348956,9.2211789659,7.358837071,0.594914772,-0.72424407,7.9537518429
"2831","51021","Bland County","Virginia",46,89,-6,-2,-43,-8,7.0127296288,13.568107325,-0.914703865,-0.304901288,-6.555377696,-1.219605153
"2832","51023","Botetourt County","Virginia",238,324,353,0,-86,353,7.1664082143,9.7559506782,10.629168486,0,-2.589542464,10.629168486
"2833","51025","Brunswick County","Virginia",154,190,41,27,-36,68,9.144350098,11.281990381,2.4345347663,1.603230212,-2.137640283,4.0377649783
"2834","51027","Buchanan County","Virginia",192,340,-309,13,-148,-296,8.3753189819,14.83129403,-13.47902899,0.5670788894,-6.455975049,-12.9119501
"2835","51029","Buckingham County","Virginia",141,157,93,3,-16,96,8.3060881859,9.2486230155,5.4784836971,0.1767252806,-0.94253483,5.6552089776
"2836","51031","Campbell County","Virginia",554,557,-36,69,-3,33,10.022070263,10.076341402,-0.651253663,1.248236188,-0.054271139,0.5969825247
"2837","51033","Caroline County","Virginia",402,255,-14,13,147,-1,13.480885312,8.5513078471,-0.469483568,0.4359490275,4.9295774648,-0.033534541
"2838","51035","Carroll County","Virginia",283,365,198,31,-82,229,9.5035008479,12.257165405,6.649092466,1.0410195275,-2.753664557,7.6901119936
"2839","51036","Charles City County","Virginia",72,57,48,2,15,50,10.274705672,8.1341419907,6.8498037817,0.2854084909,2.1405636818,7.1352122726
"2840","51037","Charlotte County","Virginia",147,131,-18,-1,16,-19,12.074913751,10.760637424,-1.478560867,-0.08214227,1.3142763266,-1.560703138
"2841","51041","Chesterfield County","Virginia",3796,2382,671,749,1414,1420,11.380551429,7.1413260021,2.0116833532,2.2455303004,4.239225427,4.2572136537
"2842","51043","Clarke County","Virginia",115,136,-53,-1,-21,-54,8.0543493486,9.5251435775,-3.712004482,-0.07003782,-1.470794229,-3.782042303
"2843","51045","Craig County","Virginia",34,48,-24,0,-14,-24,6.592980415,9.3077370564,-4.653868528,0,-2.714756641,-4.653868528
"2844","51047","Culpeper County","Virginia",635,391,-17,86,244,69,12.85412091,7.9148996468,-0.344126072,1.7408730681,4.9392212629,1.3967469965
"2845","51049","Cumberland County","Virginia",97,71,-119,0,26,-119,9.9060457516,7.2508169935,-12.15277778,0,2.6552287582,-12.15277778
"2846","51051","Dickenson County","Virginia",161,234,-70,3,-73,-67,10.541478426,15.321154979,-4.58325149,0.1964250638,-4.779676553,-4.386826426
"2847","51053","Dinwiddie County","Virginia",258,233,-47,38,25,-9,9.1800245512,8.2904872885,-1.672330054,1.3520966393,0.8895372627,-0.320233415
"2848","51057","Essex County","Virginia",126,119,11,14,7,25,11.369788847,10.738133911,0.9926006136,1.2633098719,0.6316549359,2.2559104855
"2849","51059","Fairfax County","Virginia",14984,5079,-18194,11648,9905,-6546,13.162697316,4.461648403,-15.98252236,10.232187556,8.7010489134,-5.750334799
"2850","51061","Fauquier County","Virginia",740,540,52,56,200,108,10.837488925,7.9084378638,0.7615532758,0.820134297,2.9290510607,1.5816875728
"2851","51063","Floyd County","Virginia",136,180,67,-1,-44,66,8.7530168946,11.584875302,4.312148029,-0.064360418,-2.831858407,4.2477876106
"2852","51065","Fluvanna County","Virginia",246,201,103,-5,45,98,9.4468232177,7.7187457998,3.9553772009,-0.192008602,1.7280774179,3.7633685989
"2853","51067","Franklin County","Virginia",500,621,98,-10,-121,88,8.8892839682,11.040490688,1.7422996578,-0.177785679,-2.15120672,1.5645139784
"2854","51069","Frederick County","Virginia",932,689,450,95,243,545,11.212502181,8.289070818,5.4137617825,1.1429052652,2.9234313625,6.5566670476
"2855","51071","Giles County","Virginia",166,220,-29,3,-54,-26,9.876249405,13.089005236,-1.725368872,0.178486435,-3.212755831,-1.546882437
"2856","51073","Gloucester County","Virginia",395,370,-73,33,25,-40,10.671205306,9.995812565,-1.972146803,0.891518418,0.6753927409,-1.080628385
"2857","51075","Goochland County","Virginia",170,198,330,-1,-28,329,7.7249903438,8.9973416945,14.995569491,-0.04544112,-1.272351351,14.950128371
"2858","51077","Grayson County","Virginia",126,183,90,2,-57,92,7.9051383399,11.481272351,5.6465273857,0.1254783863,-3.576134011,5.772005772
"2859","51079","Greene County","Virginia",203,176,25,34,27,59,10.603290676,9.1930007835,1.3058239749,1.7759206059,1.4102898929,3.0817445808
"2860","51081","Greensville County","Virginia",124,206,324,1,-82,325,10.6091718,17.624914442,27.72073922,0.0855578371,-7.015742642,27.806297057
"2861","51083","Halifax County","Virginia",393,469,-26,0,-76,-26,11.18510929,13.348132969,-0.739981785,0,-2.163023679,-0.739981785
"2862","51085","Hanover County","Virginia",952,924,1225,95,28,1320,9.296511855,9.0230850357,11.962423343,0.9276981368,0.2734268193,12.89012148
"2863","51087","Henrico County","Virginia",4077,2792,-658,1772,1285,1114,12.618130554,8.6411136885,-2.036480232,5.4842598338,3.977016866,3.4477796021
"2864","51089","Henry County","Virginia",431,678,-75,9,-247,-66,8.2771600315,13.020683298,-1.440341073,0.1728409287,-4.743523266,-1.267500144
"2865","51091","Highland County","Virginia",10,29,-22,0,-19,-22,4.5105999098,13.080739738,-9.923319802,0,-8.570139829,-9.923319802
"2866","51093","Isle of Wight County","Virginia",342,328,244,39,14,283,9.4980212456,9.1092133583,6.7763660349,1.0831076859,0.3888078872,7.8594737208
"2867","51095","James City County","Virginia",695,748,675,140,-53,815,9.5919620738,10.323435441,9.3159343882,1.932193799,-0.731473367,11.248128187
"2868","51097","King and Queen County","Virginia",66,79,14,0,-13,14,9.3147978265,11.149530732,1.9758662056,0,-1.834732905,1.9758662056
"2869","51099","King George County","Virginia",306,164,-32,29,142,-3,12.080298454,6.474408322,-1.263299185,1.1448648862,5.6058901324,-0.118434299
"2870","51101","King William County","Virginia",197,156,84,10,41,94,12.147371666,9.619238477,5.1795899491,0.6166178511,2.5281331895,5.7962078002
"2871","51103","Lancaster County","Virginia",98,192,41,19,-94,60,9.0376723383,17.706460091,3.7810669987,1.7522017799,-8.668787753,5.5332687785
"2872","51105","Lee County","Virginia",226,313,-68,-9,-87,-77,9.1746843665,12.706531888,-2.7605245,-0.365363537,-3.531847522,-3.125888036
"2873","51107","Loudoun County","Virginia",5172,1207,5244,2504,3965,7748,14.047782015,3.2783590278,14.243342785,6.8011690188,10.769422987,21.044511804
"2874","51109","Louisa County","Virginia",360,303,236,6,57,242,10.445530909,8.7916551814,6.8476258179,0.1740921818,1.6538757272,7.0217179997
"2875","51111","Lunenburg County","Virginia",126,130,-155,6,-4,-149,10.15719468,10.479645304,-12.49496171,0.4836759371,-0.322450625,-12.01128577
"2876","51113","Madison County","Virginia",118,141,23,14,-23,37,9.0490797546,10.812883436,1.763803681,1.0736196319,-1.763803681,2.8374233129
"2877","51115","Mathews County","Virginia",59,123,85,9,-64,94,6.6825235021,13.931362555,9.6273643674,1.0193679918,-7.248839053,10.646732359
"2878","51117","Mecklenburg County","Virginia",284,466,4,5,-182,9,9.1546458216,15.021355468,0.1289386735,0.1611733419,-5.866709646,0.2901120155
"2879","51119","Middlesex County","Virginia",96,144,78,2,-48,80,8.9988751406,13.498312711,7.3115860517,0.1874765654,-4.49943757,7.4990626172
"2880","51121","Montgomery County","Virginia",896,621,-726,676,275,-50,9.2150258401,6.3867534004,-7.466639241,6.9524078883,2.8282724398,-0.514231353
"2881","51125","Nelson County","Virginia",126,210,-23,2,-84,-21,8.5071906016,14.178651003,-1.552899872,0.1350347715,-5.671460401,-1.4178651
"2882","51127","New Kent County","Virginia",179,166,337,11,13,348,8.8616054853,8.2180251986,16.683581277,0.5445679348,0.6435802866,17.228149212
"2883","51131","Northampton County","Virginia",123,179,90,16,-56,106,10.190555095,14.830157415,7.4565037283,1.3256006628,-4.63960232,8.7821043911
"2884","51133","Northumberland County","Virginia",92,159,50,10,-67,60,7.5102040816,12.979591837,4.0816326531,0.8163265306,-5.469387755,4.8979591837
"2885","51135","Nottoway County","Virginia",183,194,95,14,-11,109,11.76432773,12.471473112,6.1071646684,0.9000032143,-0.707145383,7.0071678827
"2886","51137","Orange County","Virginia",399,405,230,38,-6,268,11.382925612,11.554097425,6.5615861921,1.0840881535,-0.171171814,7.6456743456
"2887","51139","Page County","Virginia",238,294,-71,4,-56,-67,10.032669407,12.393297502,-2.992939193,0.1686162925,-2.360628096,-2.8243229
"2888","51141","Patrick County","Virginia",120,264,-81,2,-144,-79,6.642863074,14.614298763,-4.483932575,0.1107143846,-7.971435689,-4.37321819
"2889","51143","Pittsylvania County","Virginia",482,693,-170,7,-211,-163,7.7505668205,11.143449806,-2.733602406,0.1125600991,-3.392882986,-2.621042307
"2890","51145","Powhatan County","Virginia",241,193,-512,18,48,-494,8.5243350311,6.8265421619,-18.10979061,0.636672326,1.6977928693,-17.47311828
"2891","51147","Prince Edward County","Virginia",216,276,163,38,-60,201,9.3717459216,11.975008678,7.0721971538,1.6487330788,-2.603262756,8.7209302326
"2892","51149","Prince George County","Virginia",406,199,401,189,207,590,10.737474049,5.2629491028,10.605239147,4.9984792986,5.4745249461,15.603718445
"2893","51153","Prince William County","Virginia",6908,1774,-764,2973,5134,2209,15.434146821,3.9635461002,-1.706961229,6.6424027937,11.470600721,4.9354415645
"2894","51155","Pulaski County","Virginia",303,401,99,0,-98,99,8.8231440094,11.676834151,2.8828094288,0,-2.853690142,2.8828094288
"2895","51157","Rappahannock County","Virginia",61,63,57,3,-2,60,8.2863546831,8.5580384433,7.7429871629,0.4075256402,-0.27168376,8.1505128031
"2896","51159","Richmond County","Virginia",59,127,-33,0,-68,-33,6.6791192619,14.377087225,-3.73577857,0,-7.697967963,-3.73577857
"2897","51161","Roanoke County","Virginia",790,1063,26,220,-273,246,8.4624118945,11.386764359,0.2785097586,2.3566210339,-2.924352465,2.6351307925
"2898","51163","Rockbridge County","Virginia",168,254,9,21,-86,30,7.4986609534,11.337261203,0.4017139796,0.9373326192,-3.83860025,1.3390465988
"2899","51165","Rockingham County","Virginia",812,709,365,110,103,475,10.387749619,9.0700917243,4.6693702107,1.4072074608,1.3176578951,6.0765776715
"2900","51167","Russell County","Virginia",237,364,-103,2,-127,-101,8.482766026,13.028383264,-3.686602956,0.0715845234,-4.545617238,-3.615018433
"2901","51169","Scott County","Virginia",176,344,-108,3,-168,-105,7.8638130557,15.370180063,-4.825521648,0.134042268,-7.506367008,-4.69147938
"2902","51171","Shenandoah County","Virginia",433,508,156,34,-75,190,10.120132754,11.873042584,3.6460524471,0.7946524564,-1.75290983,4.4407049035
"2903","51173","Smyth County","Virginia",315,413,-74,15,-98,-59,10.002857959,13.114858213,-2.349877743,0.4763265695,-3.112000254,-1.873551173
"2904","51175","Southampton County","Virginia",172,160,-113,2,12,-111,9.4656320511,8.8052391173,-6.218700127,0.110065489,0.6603929338,-6.108634638
"2905","51177","Spotsylvania County","Virginia",1574,848,222,202,726,424,12.166277614,6.5546400359,1.7159552924,1.5613647255,5.6116375779,3.2773200179
"2906","51179","Stafford County","Virginia",1712,653,569,490,1059,1059,12.240374647,4.6687877596,4.0682086298,3.5033782576,7.5715868874,7.5715868874
"2907","51181","Surry County","Virginia",54,77,-89,0,-23,-89,8.029739777,11.449814126,-13.23420074,0,-3.420074349,-13.23420074
"2908","51183","Sussex County","Virginia",100,134,-5,5,-34,0,8.5444525142,11.449566369,-0.427222626,0.4272226257,-2.905113855,0
"2909","51185","Tazewell County","Virginia",474,582,-375,1,-108,-374,10.986209294,13.489396222,-8.691621277,0.0231776567,-2.503186928,-8.66844362
"2910","51187","Warren County","Virginia",483,364,-1592,6,119,-1586,12.262306735,9.2411586991,-40.41737541,0.1523267917,3.0211480363,-40.26504862
"2911","51191","Washington County","Virginia",446,580,-139,13,-134,-126,8.187918231,10.647965412,-2.551839987,0.2386612937,-2.460047182,-2.313178693
"2912","51193","Westmoreland County","Virginia",185,260,190,-7,-75,183,10.574752065,14.861813713,10.860556175,-0.400125754,-4.287061648,10.460430421
"2913","51195","Wise County","Virginia",389,558,-179,10,-169,-169,9.7892419,14.04215162,-4.504561183,0.2516514627,-4.25290972,-4.25290972
"2914","51197","Wythe County","Virginia",318,402,139,2,-84,141,10.938736198,13.828213684,4.7813972688,0.068797083,-2.889477486,4.8501943518
"2915","51199","York County","Virginia",675,396,694,286,279,980,10.044568121,5.8928132975,10.327304112,4.2559207149,4.1517548233,14.583224827
"2916","51510","Alexandria city","Virginia",2811,677,-2250,2551,2134,301,18.415035998,4.4350691465,-14.73989007,16.711759812,13.979966852,1.9718697387
"2917","51520","Bristol city","Virginia",197,320,-28,-5,-123,-33,11.507009346,18.691588785,-1.635514019,-0.292056075,-7.184579439,-1.927570093
"2918","51530","Buena Vista city","Virginia",67,87,1,1,-20,2,10.242299167,13.299701903,0.1528701368,0.1528701368,-3.057402736,0.3057402736
"2919","51540","Charlottesville city","Virginia",541,290,200,457,251,657,11.76662498,6.3074329835,4.3499537817,9.9396443913,5.4591919961,14.289598173
"2920","51550","Chesapeake city","Virginia",2988,1744,-46,609,1244,563,12.754296251,7.4442746528,-0.196351281,2.5995202199,5.3100215986,2.4031689389
"2921","51570","Colonial Heights city","Virginia",231,258,10,60,-27,70,13.229482847,14.775786037,0.5727048852,3.436229311,-1.54630319,4.0089341962
"2922","51580","Covington city","Virginia",30,128,-22,7,-98,-15,5.2465897167,22.385449458,-3.847499126,1.2242042672,-17.13885974,-2.623294858
"2923","51590","Danville city","Virginia",529,689,-216,51,-160,-165,12.564723766,16.365018289,-5.130397606,1.2113438792,-3.800294523,-3.919053727
"2924","51595","Emporia city","Virginia",37,33,-77,1,4,-76,6.65347959,5.9341844992,-13.8464305,0.1798237727,0.7192950908,-13.66660673
"2925","51600","Fairfax city","Virginia",429,229,-372,293,200,-79,18.351371006,9.7959532874,-15.91307696,12.533686957,8.5554177183,-3.379389999
"2926","51610","Falls Church city","Virginia",214,73,192,47,141,239,15.68282584,5.3497490015,14.070572716,3.4443589462,10.333076839,17.514931662
"2927","51620","Franklin city","Virginia",96,145,-20,5,-49,-15,11.474332158,17.33102253,-2.390485866,0.5976214666,-5.856690372,-1.7928644
"2928","51630","Fredericksburg city","Virginia",420,198,-559,129,222,-430,14.917951268,7.0327484549,-19.85508276,4.5819421752,7.8852028131,-15.27314058
"2929","51640","Galax city","Virginia",86,174,-19,1,-88,-18,12.552911984,25.397752153,-2.773317764,0.1459640928,-12.84484017,-2.627353671
"2930","51650","Hampton city","Virginia",1745,1293,-2249,369,452,-1880,12.747275224,9.4454022149,-16.42900973,2.6955556205,3.3018730094,-13.73345411
"2931","51660","Harrisonburg city","Virginia",585,313,-569,491,272,-78,11.109739538,5.9441854282,-10.80588341,9.3245848091,5.1655541101,-1.481298605
"2932","51670","Hopewell city","Virginia",328,306,53,48,22,101,14.795768771,13.803369646,2.3907797099,2.1652344543,0.9923991249,4.5560141642
"2933","51678","Lexington city","Virginia",23,88,56,11,-65,67,3.2294299354,12.356079753,7.8629598427,1.5445099691,-9.126649817,9.4074698119
"2934","51680","Lynchburg city","Virginia",1113,890,441,443,223,884,14.139976878,11.30689975,5.6026323479,5.6280411114,2.8330771283,11.230673459
"2935","51683","Manassas city","Virginia",755,216,-491,297,539,-194,18.256559062,5.2230685528,-11.87280861,7.1817192601,13.033490509,-4.691089348
"2936","51685","Manassas Park city","Virginia",128,18,-177,197,110,20,8.0055037839,1.1257739696,-11.0701107,12.320970667,6.8797298142,1.2508599662
"2937","51690","Martinsville city","Virginia",221,289,26,4,-68,30,16.620290291,21.734225765,1.9553282695,0.3008197338,-5.113935474,2.2561480033
"2938","51700","Newport News city","Virginia",2807,1577,-2525,651,1230,-1874,15.48587128,8.7001136476,-13.93011221,3.5914863568,6.7857576326,-10.33862586
"2939","51710","Norfolk city","Virginia",3670,1967,-3289,1527,1703,-1762,14.88478487,7.9777579945,-13.33952519,6.1932061299,6.9070268758,-7.146319058
"2940","51720","Norton city","Virginia",22,50,-118,13,-28,-105,5.4047414323,12.283503255,-28.98906768,3.1937108463,-6.878761823,-25.79535684
"2941","51730","Petersburg city","Virginia",570,528,-348,68,42,-280,17.747057725,16.439379787,-10.83504577,2.1171928514,1.3076779376,-8.717852917
"2942","51735","Poquoson city","Virginia",105,105,9,0,0,9,8.7438064704,8.7438064704,0.749469126,0,0,0.749469126
"2943","51740","Portsmouth city","Virginia",1516,1050,-191,215,466,24,15.780653086,10.92987186,-1.988195738,2.2380213809,4.8507812256,0.2498256425
"2944","51750","Radford city","Virginia",135,124,-113,53,11,-60,7.774034724,7.1405948576,-6.507154991,3.0520284472,0.6334398664,-3.455126544
"2945","51760","Richmond city","Virginia",3011,1786,1828,733,1225,2561,13.753568574,8.1580449926,8.3498915154,3.3481786,5.5955235811,11.698070115
"2946","51770","Roanoke city","Virginia",1518,1084,-620,485,434,-135,15.242800337,10.884845564,-6.225649677,4.8700646664,4.3579547737,-1.35558501
"2947","51775","Salem city","Virginia",306,334,-15,43,-28,28,12.034688219,13.13590152,-0.589935697,1.6911489981,-1.101213301,1.1012133011
"2948","51790","Staunton city","Virginia",324,400,-50,60,-76,10,13.359172061,16.492805014,-2.061600627,2.4739207521,-3.133632953,0.4123201253
"2949","51800","Suffolk city","Virginia",1184,698,595,154,486,749,13.529959604,7.9762768614,6.7992617944,1.759808935,5.553682743,8.5590707295
"2950","51810","Virginia Beach city","Virginia",6119,3046,-3328,1824,3073,-1504,13.607045688,6.7735023966,-7.400596184,4.0560959854,6.8335432912,-3.344500198
"2951","51820","Waynesboro city","Virginia",294,293,172,72,1,244,13.715885234,13.669232564,8.0242593889,3.3589923023,0.0466526709,11.383251691
"2952","51830","Williamsburg city","Virginia",88,78,102,89,10,191,6.0000681826,5.3182422528,6.9546244844,6.0682507756,0.6818259298,13.02287526
"2953","51840","Winchester city","Virginia",414,281,-252,196,133,-56,15.091863517,10.243511228,-9.186351706,7.1449402158,4.8483522893,-2.04141149
"2954","53001","Adams County","Washington",384,143,-252,53,241,-199,19.977109562,7.4393923629,-13.10997815,2.7572573093,12.537717199,-10.35272084
"2955","53003","Asotin County","Washington",251,261,-43,-27,-10,-70,11.333107574,11.784625804,-1.941528389,-1.219099221,-0.45151823,-3.16062761
"2956","53005","Benton County","Washington",2699,1396,2064,408,1303,2472,14.32369752,7.4086260607,10.953727929,2.1652718,6.9150714593,13.118999729
"2957","53007","Chelan County","Washington",984,710,614,64,274,678,13.182131781,9.511497525,8.2254358878,0.8573744248,3.6706342561,9.0828103126
"2958","53009","Clallam County","Washington",663,984,961,96,-321,1057,9.100954708,13.507299295,13.191579901,1.3177852971,-4.406344587,14.509365198
"2959","53011","Clark County","Washington",5637,3388,6060,350,2249,6410,12.453839381,7.4851175846,13.388374428,0.7732559488,4.9687217969,14.161630377
"2960","53013","Columbia County","Washington",35,74,0,17,-39,17,8.8105726872,18.628067967,0,4.2794210195,-9.81749528,4.2794210195
"2961","53015","Cowlitz County","Washington",1239,1141,1087,61,98,1148,12.096715141,11.139912814,10.612695205,0.5955606325,0.9568023276,11.208255837
"2962","53017","Douglas County","Washington",540,308,428,106,232,534,13.440525674,7.6660776066,10.65286109,2.6383254101,5.7744480673,13.2911865
"2963","53019","Ferry County","Washington",70,81,-60,0,-11,-60,9.2660003971,10.722086174,-7.942286055,0,-1.456085777,-7.942286055
"2964","53021","Franklin County","Washington",1672,364,-461,197,1308,-264,18.943814369,4.1241318363,-5.22314499,2.2320164059,14.819682532,-2.991128585
"2965","53023","Garfield County","Washington",27,21,14,4,6,18,12.208907981,9.4958173186,6.330544879,1.8087271083,2.7130906624,8.1392719873
"2966","53025","Grant County","Washington",1500,660,-484,348,840,-136,16.073897063,7.0725147076,-5.186510786,3.7291441186,9.0013823551,-1.457366667
"2967","53027","Grays Harbor County","Washington",790,821,268,11,-31,279,11.14166843,11.57887314,3.7797052394,0.1551371553,-0.437204711,3.9348423948
"2968","53029","Island County","Washington",876,705,784,367,171,1151,11.037680575,8.8830648464,9.8784721128,4.6242337569,2.1546157287,14.50270587
"2969","53031","Jefferson County","Washington",194,370,365,1,-176,366,6.4164048288,12.237473127,12.072101869,0.0330742517,-5.821068298,12.10517612
"2970","53033","King County","Washington",25244,12830,7044,21341,12414,28385,11.985876569,6.0916968937,3.344498279,10.132728247,5.8941796756,13.477226526
"2971","53035","Kitsap County","Washington",3041,2150,4517,431,891,4948,11.861877968,8.3863984319,17.619238008,1.6811803368,3.4754795362,19.300418345
"2972","53037","Kittitas County","Washington",406,288,288,89,118,377,9.4761287913,6.721982985,6.721982985,2.0772794641,2.7541458063,8.7992624491
"2973","53039","Klickitat County","Washington",196,174,113,-2,22,111,9.3643247892,8.3132271088,5.398819904,-0.095554335,1.0510976804,5.3032655694
"2974","53041","Lewis County","Washington",868,885,528,56,-17,584,11.552000639,11.778249499,7.0270234301,0.7452903638,-0.22624886,7.7723137939
"2975","53043","Lincoln County","Washington",97,97,61,2,0,63,9.4560343147,9.4560343147,5.9465782804,0.1949697797,0,6.1415480601
"2976","53045","Mason County","Washington",626,676,334,140,-50,474,10.291990004,11.114033934,5.4912534526,2.3017230041,-0.82204393,7.7929764567
"2977","53047","Okanogan County","Washington",488,430,-51,100,58,49,11.815408455,10.411118106,-1.234807031,2.4211902571,1.4042903491,1.186383226
"2978","53049","Pacific County","Washington",193,321,404,21,-128,425,9.3157958248,15.49414746,19.500422348,1.0136358151,-6.178351635,20.514058163
"2979","53051","Pend Oreille County","Washington",123,139,179,5,-16,184,9.4600830641,10.690662975,13.767112752,0.3845562221,-1.230579911,14.151668974
"2980","53053","Pierce County","Washington",11515,6373,5357,2279,5142,7636,13.785251756,7.6294754182,6.4131648855,2.7283186063,6.1557763377,9.1414834918
"2981","53055","San Juan County","Washington",88,150,223,25,-62,248,5.4644808743,9.3144560358,13.847491307,1.5524093393,-3.849975161,15.399900646
"2982","53057","Skagit County","Washington",1383,1164,1099,293,219,1392,11.448865047,9.6359211245,9.0978327456,2.4255368466,1.8129439229,11.523369592
"2983","53059","Skamania County","Washington",86,80,-9,6,6,-3,7.5587782905,7.0314216656,-0.791034937,0.5273566249,0.5273566249,-0.263678312
"2984","53061","Snohomish County","Washington",9730,5146,4848,3213,4584,8061,12.740054443,6.7379568514,6.3477681336,4.2069676183,6.0020975917,10.554735752
"2985","53063","Spokane County","Washington",5954,4453,3458,869,1501,4327,12.255126457,9.1656160753,7.1176061955,1.7886639051,3.0895103816,8.9062701006
"2986","53065","Stevens County","Washington",430,469,116,2,-39,118,9.8834670283,10.779874503,2.6662376169,0.0459696141,-0.896407475,2.712207231
"2987","53067","Thurston County","Washington",3152,2192,1417,673,960,2090,11.827636218,8.2253104661,5.3171829062,2.5253804488,3.6023257516,7.842563355
"2988","53069","Wahkiakum County","Washington",23,49,3,8,-26,11,5.7001239157,12.143742255,0.7434944238,1.9826517968,-6.44361834,2.7261462206
"2989","53071","Walla Walla County","Washington",684,611,311,57,73,368,11.4465493,10.224914653,5.2044982931,0.9538791084,1.2216346476,6.1583774014
"2990","53073","Whatcom County","Washington",2358,1560,2332,566,798,2898,11.22442908,7.4258309433,11.100665231,2.694243791,3.7985981364,13.794909022
"2991","53075","Whitman County","Washington",456,285,574,453,171,1027,9.5955557426,5.9972223391,12.07861622,9.5324270864,3.5983334035,21.611043306
"2992","53077","Yakima County","Washington",4068,1909,-1313,183,2159,-1130,16.432678733,7.7114020896,-5.303861154,0.7392281731,8.721276643,-4.564632981
"2993","54001","Barbour County","West Virginia",172,200,102,-6,-28,96,10.155281337,11.808466671,6.022318002,-0.354254,-1.653185334,5.6680640019
"2994","54003","Berkeley County","West Virginia",1391,1006,1090,13,385,1103,12.538874115,9.0683733718,9.8255735341,0.1171857394,3.4705007437,9.9427592734
"2995","54005","Boone County","West Virginia",230,343,-355,0,-113,-355,9.7964051452,14.609421586,-15.12053838,0,-4.813016441,-15.12053838
"2996","54007","Braxton County","West Virginia",177,169,-38,0,8,-38,12.301918265,11.745899361,-2.641089797,0,0.5560189046,-2.641089797
"2997","54009","Brooke County","West Virginia",211,344,-40,-3,-133,-43,9.0579321299,14.767434373,-1.717143532,-0.128785765,-5.709502243,-1.845929297
"2998","54011","Cabell County","West Virginia",1128,1286,51,56,-158,107,11.676716441,13.312284879,0.5279366476,0.5796951425,-1.635568438,1.1076317901
"2999","54013","Calhoun County","West Virginia",62,90,-64,0,-28,-64,8.2529118136,11.980033278,-8.519134775,0,-3.727121464,-8.519134775
"3000","54015","Clay County","West Virginia",113,117,-2,0,-4,-2,12.729525741,13.180128422,-0.225301341,0,-0.450602681,-0.225301341
"3001","54017","Doddridge County","West Virginia",67,90,249,-1,-23,248,7.8034008852,10.482180294,29.000698812,-0.11646867,-2.678779408,28.884230142
"3002","54019","Fayette County","West Virginia",501,679,-296,20,-178,-276,11.149810275,15.111219914,-6.587512658,0.4451022066,-3.961409639,-6.142410451
"3003","54021","Gilmer County","West Virginia",54,74,-183,8,-20,-175,6.4274236743,8.8079509611,-21.78182467,0.9522109147,-2.380527287,-20.82961376
"3004","54023","Grant County","West Virginia",135,138,40,-3,-3,37,11.582514693,11.839903908,3.4318562052,-0.257389215,-0.257389215,3.1744669898
"3005","54025","Greenbrier County","West Virginia",355,479,42,91,-124,133,9.9766742546,13.461484417,1.1803389259,2.5574010061,-3.484810162,3.737739932
"3006","54027","Hampshire County","West Virginia",229,255,-88,-8,-26,-96,9.7961628131,10.908390905,-3.764464312,-0.342224028,-1.112228092,-4.106688341
"3007","54029","Hancock County","West Virginia",290,438,-142,14,-148,-128,9.6319914973,14.547628537,-4.716354457,0.464992693,-4.91563704,-4.251361764
"3008","54031","Hardy County","West Virginia",138,166,-160,64,-28,-96,9.9334173115,11.948893288,-11.51700558,4.6068022314,-2.015475976,-6.910203347
"3009","54033","Harrison County","West Virginia",804,849,-88,1,-45,-87,11.718493795,12.374379641,-1.282621211,0.014575241,-0.655885847,-1.26804597
"3010","54035","Jackson County","West Virginia",347,359,32,16,-12,48,11.905170343,12.316876522,1.0978831441,0.548941572,-0.411706179,1.6468247161
"3011","54037","Jefferson County","West Virginia",555,458,333,32,97,365,9.9368873372,8.2001700909,5.9621324023,0.5729376483,1.7367172463,6.5350700506
"3012","54039","Kanawha County","West Virginia",2037,2541,-1710,128,-504,-1582,10.760043632,13.422322469,-9.032731767,0.6761343077,-2.662278837,-8.35659746
"3013","54041","Lewis County","West Virginia",189,226,14,14,-37,28,11.495301524,13.745704467,0.8515038166,0.8515038166,-2.250402944,1.7030076331
"3014","54043","Lincoln County","West Virginia",227,246,-218,-5,-19,-223,10.607476636,11.495327103,-10.18691589,-0.23364486,-0.887850467,-10.42056075
"3015","54045","Logan County","West Virginia",373,528,-665,0,-155,-665,10.705316783,15.153906867,-19.08588649,0,-4.448590084,-19.08588649
"3016","54047","McDowell County","West Virginia",221,343,-533,22,-122,-511,11.008443127,17.085502229,-26.5497746,1.0958631167,-6.077059102,-25.45391148
"3017","54049","Marion County","West Virginia",630,711,43,8,-81,51,11.098974666,12.525985695,0.7575490645,0.1409393608,-1.427011029,0.8984884254
"3018","54051","Marshall County","West Virginia",331,404,-69,0,-73,-69,10.258953339,12.52150196,-2.138573355,0,-2.262548622,-2.138573355
"3019","54053","Mason County","West Virginia",289,340,-9,-3,-51,-12,10.658503753,12.53941618,-0.331925722,-0.110641907,-1.880912427,-0.44256763
"3020","54055","Mercer County","West Virginia",752,902,-498,10,-150,-488,12.238985727,14.680272773,-8.105072994,0.1627524698,-2.441287047,-7.942320525
"3021","54057","Mineral County","West Virginia",276,323,-125,18,-47,-107,10.050617239,11.762135392,-4.551909981,0.6554750373,-1.711518153,-3.896434944
"3022","54059","Mingo County","West Virginia",342,354,-413,0,-12,-413,13.396267064,13.866311522,-16.17736344,0,-0.470044458,-16.17736344
"3023","54061","Monongalia County","West Virginia",1204,695,86,636,509,722,11.566246542,6.6765293575,0.8261604673,6.1097448509,4.8897171841,6.9359053182
"3024","54063","Monroe County","West Virginia",119,187,25,11,-68,36,8.7532180949,13.755057006,1.8389113645,0.8091210004,-5.001838911,2.6480323648
"3025","54065","Morgan County","West Virginia",140,214,55,-6,-74,49,7.9993143445,12.227523355,3.1425877782,-0.342827758,-4.228209011,2.7997600206
"3026","54067","Nicholas County","West Virginia",275,345,-117,20,-70,-97,10.727939455,13.45868768,-4.564250605,0.7802137786,-2.730748225,-3.784036826
"3027","54069","Ohio County","West Virginia",476,615,-136,12,-139,-124,11.03678542,14.259712255,-3.153367263,0.2782382879,-3.222926835,-2.875128975
"3028","54071","Pendleton County","West Virginia",55,89,-96,4,-34,-92,7.6745970837,12.418893463,-13.39566036,0.5581525152,-4.744296379,-12.83750785
"3029","54073","Pleasants County","West Virginia",79,108,-59,-2,-29,-61,10.472592298,14.316961623,-7.821303109,-0.265128919,-3.844369325,-8.086432028
"3030","54075","Pocahontas County","West Virginia",82,108,-52,0,-26,-52,9.5204922791,12.539184953,-6.037385348,0,-3.018692674,-6.037385348
"3031","54077","Preston County","West Virginia",348,363,-103,45,-15,-58,10.27124347,10.713969481,-3.040051947,1.3281780349,-0.442726012,-1.711873912
"3032","54079","Putnam County","West Virginia",635,592,-80,8,43,-72,11.215712595,10.456223396,-1.413003162,0.1413003162,0.7594891994,-1.271702845
"3033","54081","Raleigh County","West Virginia",843,1029,-669,39,-186,-630,10.838540461,13.2299622,-8.601403996,0.5014271388,-2.391421739,-8.099976857
"3034","54083","Randolph County","West Virginia",312,371,-123,16,-59,-107,10.652099693,12.666439058,-4.199385456,0.5462615227,-2.014339365,-3.653123933
"3035","54085","Ritchie County","West Virginia",112,143,39,-1,-31,38,11.112213513,14.187915468,3.8694314912,-0.099216192,-3.075701955,3.7702152991
"3036","54087","Roane County","West Virginia",139,203,-158,3,-64,-155,9.5954714897,14.013530305,-10.9070827,0.207096507,-4.418058815,-10.69998619
"3037","54089","Summers County","West Virginia",97,201,-90,-2,-104,-92,7.3309904395,15.191021426,-6.801949892,-0.151154442,-7.860030987,-6.953104334
"3038","54091","Taylor County","West Virginia",163,205,-134,5,-42,-129,9.5803455977,12.048900905,-7.875866933,0.2938756318,-2.468555307,-7.581991301
"3039","54093","Tucker County","West Virginia",69,75,43,0,-6,43,9.7602376406,10.608953957,6.0824669354,0,-0.848716317,6.0824669354
"3040","54095","Tyler County","West Virginia",87,118,-102,-1,-31,-103,9.6463022508,13.083490409,-11.30945781,-0.110877037,-3.437188158,-11.42033485
"3041","54097","Upshur County","West Virginia",270,250,29,17,20,46,10.934051471,10.124121732,1.174398121,0.6884402778,0.8099297386,1.8628383988
"3042","54099","Wayne County","West Virginia",420,538,-183,-9,-118,-192,10.156949046,13.010568064,-4.425527799,-0.217648908,-2.853619018,-4.643176707
"3043","54101","Webster County","West Virginia",90,128,-78,0,-38,-78,10.352562259,14.723644102,-8.972220625,0,-4.371081843,-8.972220625
"3044","54103","Wetzel County","West Virginia",184,225,-136,-3,-41,-139,11.596395034,14.180374362,-8.571248503,-0.189071658,-2.583979328,-8.760320161
"3045","54105","Wirt County","West Virginia",58,74,31,0,-16,31,10.003449465,12.763021732,5.346671266,0,-2.759572266,5.346671266
"3046","54107","Wood County","West Virginia",987,1126,21,-9,-139,12,11.424206122,13.033086214,0.2430682154,-0.104172092,-1.608880092,0.1388961231
"3047","54109","Wyoming County","West Virginia",218,322,-302,-1,-104,-303,9.7432344857,14.391383048,-13.49750832,-0.044693736,-4.648148562,-13.54220206
"3048","55001","Adams County","Wisconsin",138,232,-13,4,-94,-9,6.873536883,11.555511282,-0.647507098,0.1992329531,-4.681974399,-0.448274145
"3049","55003","Ashland County","Wisconsin",178,204,-172,7,-26,-165,11.192504795,12.827365045,-10.81522935,0.4401546829,-1.634860251,-10.37507467
"3050","55005","Barron County","Wisconsin",517,490,-32,25,27,-7,11.400220507,10.804851158,-0.705622933,0.5512679162,0.5953693495,-0.154355017
"3051","55007","Bayfield County","Wisconsin",131,153,23,5,-22,28,8.7464530129,10.215322984,1.5356367885,0.3338340845,-1.468869972,1.869470873
"3052","55009","Brown County","Wisconsin",3324,2022,-30,416,1302,386,12.930229663,7.8655007158,-0.116698824,1.6182236883,5.0647289475,1.5015248646
"3053","55011","Buffalo County","Wisconsin",156,110,-37,3,46,-34,11.786483321,8.3109818292,-2.79551207,0.2266631408,3.4755014922,-2.568848929
"3054","55013","Burnett County","Wisconsin",134,192,-35,4,-58,-31,8.8250790306,12.644889357,-2.305057956,0.2634351949,-3.819810327,-2.041622761
"3055","55015","Calumet County","Wisconsin",538,287,71,25,251,96,10.837597196,5.7813947867,1.4302405221,0.5036058177,5.0562024093,1.9338463398
"3056","55017","Chippewa County","Wisconsin",729,630,-19,10,99,-9,11.50295858,9.9408284024,-0.299802761,0.157790927,1.5621301775,-0.142011834
"3057","55019","Clark County","Wisconsin",538,342,-209,10,196,-199,15.661615941,9.9558971224,-6.084159353,0.291108103,5.7057188187,-5.79305125
"3058","55021","Columbia County","Wisconsin",568,562,8,27,6,35,10.025593505,9.9196893478,0.1412055423,0.4765687053,0.1059041567,0.6177742476
"3059","55023","Crawford County","Wisconsin",145,166,-6,10,-21,4,8.8752869166,10.160673298,-0.367253252,0.6120887529,-1.285386381,0.2448355011
"3060","55025","Dane County","Wisconsin",6187,3221,1399,2173,2966,3572,11.907408209,6.1990887089,2.6924945991,4.182123491,5.7083195004,6.8746180901
"3061","55027","Dodge County","Wisconsin",817,968,-118,13,-151,-105,9.2884712677,11.005189948,-1.34154175,0.1477969724,-1.71671868,-1.193744777
"3062","55029","Door County","Wisconsin",209,355,-13,5,-146,-8,7.6314972706,12.962591058,-0.474686433,0.182571705,-5.331093787,-0.292114728
"3063","55031","Douglas County","Wisconsin",399,389,-195,31,10,-164,9.1593590744,8.9298012029,-4.476378495,0.7116294018,0.2295578715,-3.764749093
"3064","55033","Dunn County","Wisconsin",465,336,0,48,129,48,10.529295217,7.6082649307,0,1.0868949901,2.9210302859,1.0868949901
"3065","55035","Eau Claire County","Wisconsin",1235,900,-48,158,335,110,12.119308954,8.8318850677,-0.47103387,1.5504864897,3.2874238863,1.0794526194
"3066","55037","Florence County","Wisconsin",22,45,24,0,-23,24,5.0627085491,10.355540214,5.5229547808,0,-5.292831665,5.5229547808
"3067","55039","Fond du Lac County","Wisconsin",1073,935,-345,177,138,-168,10.522857549,9.1694984235,-3.383397814,1.7358301829,1.3533591256,-1.647567631
"3068","55041","Forest County","Wisconsin",109,116,-95,4,-7,-91,12.039542718,12.812724361,-10.49317943,0.4418180814,-0.773181642,-10.05136135
"3069","55043","Grant County","Wisconsin",577,555,329,53,22,382,11.121176493,10.6971455,6.3411907561,1.02152921,0.4240309928,7.3627199661
"3070","55045","Green County","Wisconsin",400,339,-19,26,61,7,10.843928755,9.1902296202,-0.515086616,0.7048553691,1.6536991352,0.1897687532
"3071","55047","Green Lake County","Wisconsin",189,251,11,8,-62,19,10.087801233,13.397027034,0.5871207067,0.4269968776,-3.309225801,1.0141175843
"3072","55049","Iowa County","Wisconsin",228,195,-37,11,33,-26,9.6659318297,8.2669153807,-1.5685942,0.4663388163,1.399016449,-1.102255384
"3073","55051","Iron County","Wisconsin",35,74,-101,-1,-39,-102,6.045949214,12.782864053,-17.44688202,-0.172741406,-6.736914838,-17.61962342
"3074","55053","Jackson County","Wisconsin",277,233,-102,3,44,-99,13.479974695,11.338751277,-4.963745194,0.1459925057,2.1412234172,-4.817752689
"3075","55055","Jefferson County","Wisconsin",844,648,-101,49,196,-52,9.9957364157,7.6744516557,-1.196172249,0.58032119,2.3212847601,-0.615851059
"3076","55057","Juneau County","Wisconsin",292,264,-54,5,28,-49,11.091696422,10.028109094,-2.051204133,0.1899263086,1.0635873281,-1.861277824
"3077","55059","Kenosha County","Wisconsin",1904,1430,-503,149,474,-354,11.339306718,8.5163910751,-2.995625672,0.8873722169,2.8229156431,-2.108253455
"3078","55061","Kewaunee County","Wisconsin",182,188,-26,14,-6,-12,8.9538287457,9.2490099132,-1.279118392,0.6887560574,-0.295181167,-0.590362335
"3079","55063","La Crosse County","Wisconsin",1271,992,-52,70,279,18,10.809109928,8.4363784804,-0.442229517,0.5953089654,2.3727314476,0.1530794482
"3080","55065","Lafayette County","Wisconsin",231,125,-93,1,106,-92,13.762287757,7.4471254096,-5.540661305,0.0595770033,6.3151623473,-5.481084301
"3081","55067","Langlade County","Wisconsin",174,267,-133,19,-93,-114,9.0873482178,13.944379162,-6.946076511,0.9922966445,-4.857030944,-5.953779867
"3082","55069","Lincoln County","Wisconsin",246,336,-158,3,-90,-155,8.7916800686,12.008148386,-5.646688825,0.1072156106,-3.216468318,-5.539473214
"3083","55071","Manitowoc County","Wisconsin",786,920,-401,75,-134,-326,9.8586426179,11.539378128,-5.029663727,0.9407101735,-1.68073551,-4.088953554
"3084","55073","Marathon County","Wisconsin",1622,1096,-423,64,526,-359,11.996154131,8.1059093262,-3.128466829,0.4733377709,3.8902448044,-2.655129059
"3085","55075","Marinette County","Wisconsin",358,503,-258,8,-145,-250,8.7637698898,12.313341493,-6.315789474,0.1958384333,-3.549571603,-6.11995104
"3086","55077","Marquette County","Wisconsin",155,196,85,2,-41,87,10.268640896,12.984862036,5.6311901686,0.1324985922,-2.71622114,5.7636887608
"3087","55078","Menominee County","Wisconsin",97,34,-59,18,63,-41,21.486321852,7.5312880718,-13.06899989,3.9871525086,13.95503378,-9.081847381
"3088","55079","Milwaukee County","Wisconsin",13982,8105,-8770,3004,5877,-5766,14.585854371,8.455038598,-9.148758606,3.1337366994,6.130815773,-6.015021907
"3089","55081","Monroe County","Wisconsin",605,386,-104,36,219,-68,13.375486381,8.5337813937,-2.299257163,0.7958967103,4.8417049876,-1.503360453
"3090","55083","Oconto County","Wisconsin",394,367,-26,18,27,-8,10.514938418,9.7943715723,-0.693879185,0.4803778973,0.7205668459,-0.213501288
"3091","55085","Oneida County","Wisconsin",294,480,162,13,-186,175,8.3249564639,13.591765655,4.5872209087,0.3681103198,-5.266809191,4.9553312285
"3092","55087","Outagamie County","Wisconsin",2353,1497,133,281,856,414,12.872448966,8.1895691039,0.7275969879,1.5372537864,4.6828798617,2.2648507742
"3093","55089","Ozaukee County","Wisconsin",832,742,152,122,90,274,9.4807251843,8.4551659697,1.7320555625,1.390202491,1.0255592146,3.1222580535
"3094","55091","Pepin County","Wisconsin",78,72,-69,1,6,-68,10.735668571,9.9098479114,-9.496937582,0.1376367765,0.8258206593,-9.359300805
"3095","55093","Pierce County","Wisconsin",390,293,-130,44,97,-86,9.5045451222,7.1405941559,-3.168181707,1.0723076548,2.3639509663,-2.095874053
"3096","55095","Polk County","Wisconsin",414,440,-96,9,-26,-87,9.5673876872,10.168238122,-2.218524681,0.2079866889,-0.600850434,-2.010537992
"3097","55097","Portage County","Wisconsin",704,559,-313,146,145,-167,9.9845409806,7.9280659207,-4.439149612,2.0706576465,2.0564750599,-2.368491966
"3098","55099","Price County","Wisconsin",99,205,19,10,-106,29,7.2705908273,15.055263834,1.3953659164,0.7344031139,-7.784673007,2.1297690302
"3099","55101","Racine County","Wisconsin",2381,1838,-789,132,543,-657,12.224581112,9.436698901,-4.050900671,0.6777172225,2.7878822107,-3.373183448
"3100","55103","Richland County","Wisconsin",176,199,-176,13,-23,-163,9.9705415817,11.273510084,-9.970541582,0.7364604577,-1.302968502,-9.234081124
"3101","55105","Rock County","Wisconsin",2028,1517,-508,111,511,-397,12.596195055,9.4223017248,-3.155259905,0.6894367116,3.1738933299,-2.465823194
"3102","55107","Rusk County","Wisconsin",136,204,-184,27,-68,-157,9.551567932,14.327351898,-12.92270956,1.896267163,-4.775783966,-11.02644239
"3103","55109","St. Croix County","Wisconsin",1072,569,70,30,503,100,12.34432846,6.5521668787,0.8060662241,0.3454569532,5.7921615817,1.1515231773
"3104","55111","Sauk County","Wisconsin",790,581,43,45,209,88,12.515941983,9.2047623951,0.681247475,0.7129334041,3.3111795879,1.3941808791
"3105","55113","Sawyer County","Wisconsin",172,216,-27,1,-44,-26,10.535665064,13.230835196,-1.6538544,0.0612538667,-2.695170133,-1.592600533
"3106","55115","Shawano County","Wisconsin",443,462,-284,18,-19,-266,10.751252897,11.212367581,-6.892451067,0.4368454902,-0.461114684,-6.455605577
"3107","55117","Sheboygan County","Wisconsin",1279,1123,-34,131,156,97,11.1102907,9.7551653296,-0.295347837,1.1379578434,1.3551253708,0.8426100062
"3108","55119","Taylor County","Wisconsin",232,183,-167,22,49,-145,11.390416339,8.9846818539,-8.199135899,1.0801256874,2.4057344855,-7.119010212
"3109","55121","Trempealeau County","Wisconsin",415,264,-144,27,151,-117,14.103653356,8.9719626168,-4.893797791,0.9175870858,5.1316907392,-3.976210705
"3110","55123","Vernon County","Wisconsin",435,321,12,6,114,18,14.378264031,10.610167251,0.3966417664,0.1983208832,3.7680967806,0.5949626496
"3111","55125","Vilas County","Wisconsin",193,311,133,18,-118,151,9.0106914422,14.519818852,6.2094402166,0.8403753677,-5.50912741,7.0498155843
"3112","55127","Walworth County","Wisconsin",1091,955,-868,45,136,-823,10.607371686,9.2850962053,-8.439228802,0.4375176222,1.3222754805,-8.00171118
"3113","55129","Washburn County","Wisconsin",151,199,-96,8,-48,-88,9.6866279629,12.765820958,-6.15838599,0.5131988325,-3.079192995,-5.645187157
"3114","55131","Washington County","Wisconsin",1325,1158,65,114,167,179,9.9053571162,8.6569083325,0.4859231793,0.8522344991,1.2484487837,1.3381576783
"3115","55133","Waukesha County","Wisconsin",3802,3366,-187,610,436,423,9.6047452797,8.5033068415,-0.472405936,1.5410033195,1.1014384382,1.0685973838
"3116","55135","Waupaca County","Wisconsin",519,738,-57,15,-219,-42,10.016404516,14.242979832,-1.100067548,0.28949146,-4.226575316,-0.810576088
"3117","55137","Waushara County","Wisconsin",247,272,-122,3,-25,-119,10.283311476,11.324132476,-5.079206478,0.12489852,-1.040821,-4.954307958
"3118","55139","Winnebago County","Wisconsin",1829,1467,-595,181,362,-414,10.803307738,8.6650915535,-3.514471353,1.0691080921,2.1382161843,-2.44536326
"3119","55141","Wood County","Wisconsin",811,868,-218,49,-57,-169,11.037242186,11.812979307,-2.96685425,0.6668617351,-0.77573712,-2.299992515
"3120","56001","Albany County","Wyoming",414,178,-159,259,236,100,10.955569081,4.7103654503,-4.207573633,6.8538463574,6.2452036307,2.6462727249
"3121","56003","Big Horn County","Wyoming",158,123,64,-2,35,62,13.275637525,10.334831744,5.3774734277,-0.168046045,2.9408057808,5.2094273831
"3122","56005","Campbell County","Wyoming",767,274,601,37,493,638,15.749324956,5.6262256034,12.340735721,0.7597457932,10.123099352,13.100481515
"3123","56007","Carbon County","Wyoming",217,134,-347,6,83,-341,13.782153064,8.5106382979,-22.03874246,0.3810733566,5.2715147666,-21.6576691
"3124","56009","Converse County","Wyoming",218,132,-5,14,86,9,15.297172128,9.2625078942,-0.350852572,0.9823872009,6.0346642341,0.6315346291
"3125","56011","Crook County","Wyoming",114,62,125,22,52,147,15.537685703,8.4503202944,17.036936077,2.9985007496,7.0873654082,20.035436827
"3126","56013","Fremont County","Wyoming",576,438,-481,6,138,-475,14.259190494,10.842926105,-11.90741428,0.1485332343,3.4162643892,-11.75888105
"3127","56015","Goshen County","Wyoming",147,142,-5,27,5,22,10.857923699,10.488606566,-0.369317133,1.9943125162,0.3693171326,1.6249953835
"3128","56017","Hot Springs County","Wyoming",45,78,-37,1,-33,-36,9.4706934652,16.415868673,-7.787014627,0.2104598548,-6.945175208,-7.576554772
"3129","56019","Johnson County","Wyoming",77,95,46,0,-18,46,8.9581757897,11.052294805,5.3516374847,0,-2.094119016,5.3516374847
"3130","56021","Laramie County","Wyoming",1311,848,320,196,463,516,13.582395723,8.7855618408,3.315306355,2.0306251425,4.7968338824,5.3459314975
"3131","56023","Lincoln County","Wyoming",248,136,69,-5,112,64,13.297230637,7.2920297043,3.6996327176,-0.268089327,6.005200933,3.4315433903
"3132","56025","Natrona County","Wyoming",1178,735,226,89,443,315,14.409962201,8.9909356689,2.7645598111,1.0886983327,5.4190265324,3.8532581438
"3133","56027","Niobrara County","Wyoming",35,39,12,0,-4,12,14.042126379,15.646940822,4.81444333,0,-1.604814443,4.81444333
"3134","56029","Park County","Wyoming",343,279,-90,-8,64,-98,11.85067459,9.6394700019,-3.109506452,-0.276400574,2.2112045882,-3.385907026
"3135","56031","Platte County","Wyoming",92,98,30,2,-6,32,10.472992202,11.156013433,3.4151061529,0.2276737435,-0.683021231,3.6427798964
"3136","56033","Sheridan County","Wyoming",330,332,30,13,-2,43,11.048983828,11.115947367,1.0044530753,0.4352629993,-0.066963538,1.4397160746
"3137","56035","Sublette County","Wyoming",144,47,-199,-7,97,-206,14.258837509,4.6539261313,-19.70492128,-0.693137934,9.6049113774,-20.39805921
"3138","56037","Sweetwater County","Wyoming",641,261,-649,58,380,-591,14.290332289,5.8186844423,-14.46868277,1.2930409872,8.471647847,-13.17564178
"3139","56039","Teton County","Wyoming",262,94,36,37,168,73,11.442796934,4.1054309611,1.5722927085,1.615967506,7.337365973,3.1882602144
"3140","56041","Uinta County","Wyoming",305,150,-219,3,155,-216,14.664519076,7.2120585619,-10.5296055,0.1442411712,7.452460514,-10.38536433
"3141","56043","Washakie County","Wyoming",101,95,4,-3,6,1,12.201751737,11.476895198,0.4832376925,-0.362428269,0.7248565388,0.1208094231
"3142","56045","Weston County","Wyoming",74,68,24,31,6,55,10.324380886,9.4872689222,3.3484478549,4.3250784792,0.8371119637,7.6735263341
